Rk,Player,Pos,Age,Tm,G,GS,MP,FG,FGA,FG%,3P,3PA,3P%,2P,2PA,2P%,eFG%,FT,FTA,FT%,ORB,DRB,TRB,AST,STL,BLK,TOV,PF,PTS
1,Precious Achiuwa\achiupr01,PF,21,MIA,55,3,683,112,207,.541,0,0,,112,207,.541,.541,53,103,.515,70,127,197,27,18,26,41,88,277
2,Jaylen Adams\adamsja01,PG,24,MIL,7,0,18,1,8,.125,0,2,.000,1,6,.167,.125,0,0,,0,3,3,2,0,0,0,1,2
3,Steven Adams\adamsst01,C,27,NOP,57,57,1581,189,305,.620,0,3,.000,189,302,.626,.620,59,133,.444,212,294,506,109,54,37,78,113,437
4,Bam Adebayo\adebaba01,C,23,MIA,56,56,1877,405,712,.569,2,8,.250,403,704,.572,.570,261,324,.806,128,382,510,291,61,61,151,126,1073
5,LaMarcus Aldridge\aldrila01,C,35,TOT,26,23,674,140,296,.473,31,80,.388,109,216,.505,.525,41,47,.872,19,99,118,49,11,29,27,47,352
5,LaMarcus Aldridge\aldrila01,C,35,SAS,21,18,544,115,248,.464,27,75,.360,88,173,.509,.518,31,37,.838,17,77,94,36,8,18,20,36,288
5,LaMarcus Aldridge\aldrila01,C,35,BRK,5,5,130,25,48,.521,4,5,.800,21,43,.488,.563,10,10,1.000,2,22,24,13,3,11,7,11,64
6,Ty-Shon Alexander\alexaty01,SG,22,PHO,10,0,29,2,10,.200,1,7,.143,1,3,.333,.250,1,2,.500,1,4,5,1,0,1,1,1,6
7,Nickeil Alexander-Walker\alexani01,SG,22,NOP,41,10,851,158,378,.418,65,187,.348,93,191,.487,.504,39,52,.750,10,116,126,81,40,21,57,77,420
8,Grayson Allen\allengr01,SG,25,MEM,48,36,1227,173,409,.423,107,270,.396,66,139,.475,.554,75,87,.862,18,137,155,103,45,8,47,71,528
9,Jarrett Allen\allenja01,C,22,TOT,53,35,1551,260,406,.640,5,14,.357,255,392,.651,.647,179,251,.713,162,362,524,85,27,82,80,86,704
9,Jarrett Allen\allenja01,C,22,BRK,12,5,320,44,65,.677,0,0,,44,65,.677,.677,46,61,.754,38,87,125,20,7,19,22,21,134
9,Jarrett Allen\allenja01,C,22,CLE,41,30,1231,216,341,.633,5,14,.357,211,327,.645,.641,133,190,.700,124,275,399,65,20,63,58,65,570
10,Al-Farouq Aminu\aminual01,PF,30,TOT,20,14,391,36,92,.391,7,33,.212,29,59,.492,.429,16,19,.842,20,80,100,30,17,9,27,25,95
10,Al-Farouq Aminu\aminual01,PF,30,ORL,17,14,367,36,89,.404,7,31,.226,29,58,.500,.444,14,17,.824,20,71,91,29,17,9,25,22,93
10,Al-Farouq Aminu\aminual01,PF,30,CHI,3,0,24,0,3,.000,0,2,.000,0,1,.000,.000,2,2,1.000,0,9,9,1,0,0,2,3,2
11,Kyle Anderson\anderky01,PF,27,MEM,59,59,1601,257,557,.461,76,220,.345,181,337,.537,.530,121,155,.781,48,303,351,208,74,46,72,104,711
12,Giannis Antetokounmpo\antetgi01,PF,26,MIL,52,52,1750,536,944,.568,57,187,.305,479,757,.633,.598,352,514,.685,87,505,592,314,63,66,190,143,1481
13,Kostas Antetokounmpo\antetko01,PF,23,LAL,14,0,53,3,10,.300,0,0,,3,10,.300,.300,6,13,.462,4,15,19,1,2,4,10,7,12
14,Thanasis Antetokounmpo\antetth01,SF,28,MIL,49,2,495,66,128,.516,7,26,.269,59,102,.578,.543,18,39,.462,53,66,119,42,19,10,40,67,157
15,Carmelo Anthony\anthoca01,PF,36,POR,61,3,1511,295,705,.418,116,290,.400,179,415,.431,.501,124,141,.879,30,167,197,93,44,35,58,125,830
16,Cole Anthony\anthoco01,PG,20,ORL,37,24,1000,164,417,.393,41,130,.315,123,287,.429,.442,74,91,.813,31,136,167,161,23,17,71,77,443
17,OG Anunoby\anunoog01,SF,23,TOR,41,41,1358,234,481,.486,97,244,.398,137,237,.578,.587,75,97,.773,53,176,229,87,64,29,72,112,640
18,Ryan Arcidiacono\arcidry01,PG,26,CHI,37,0,395,39,99,.394,18,57,.316,21,42,.500,.485,12,18,.667,5,55,60,49,8,0,7,42,108
19,Trevor Ariza\arizatr01,SF,35,MIA,22,19,600,64,166,.386,35,101,.347,29,65,.446,.491,24,32,.750,17,85,102,40,17,13,14,38,187
20,D.J. Augustin\augusdj01,PG,33,TOT,51,6,981,110,286,.385,67,179,.374,43,107,.402,.502,69,74,.932,18,64,82,166,26,1,55,51,356
20,D.J. Augustin\augusdj01,PG,33,MIL,37,6,713,71,192,.370,49,129,.380,22,63,.349,.497,36,40,.900,11,39,50,110,20,1,34,33,227
20,D.J. Augustin\augusdj01,PG,33,HOU,14,0,268,39,94,.415,18,50,.360,21,44,.477,.511,33,34,.971,7,25,32,56,6,0,21,18,129
21,Deni Avdija\avdijde01,SF,20,WAS,54,32,1257,130,312,.417,53,168,.315,77,144,.535,.502,29,45,.644,22,240,262,63,32,15,33,140,342
22,Deandre Ayton\aytonde01,C,22,PHO,62,62,1904,397,640,.620,4,20,.200,393,620,.634,.623,121,159,.761,211,455,666,89,36,68,97,181,919
23,Udoka Azubuike\azubuud01,C,21,UTA,12,0,49,4,7,.571,0,0,,4,7,.571,.571,4,6,.667,4,9,13,0,1,4,3,8,12
24,Dwayne Bacon\bacondw01,SG,25,ORL,62,41,1581,244,605,.403,56,183,.306,188,422,.445,.450,118,142,.831,22,164,186,75,36,4,40,93,662
25,Marvin Bagley III\baglema01,PF,21,SAC,37,37,951,209,416,.502,34,96,.354,175,320,.547,.543,61,109,.560,91,184,275,35,18,19,49,90,513
26,LaMelo Ball\ballla01,PG,19,CHO,41,21,1174,237,526,.451,81,216,.375,156,310,.503,.528,97,123,.789,54,186,240,251,65,14,115,116,652
27,Lonzo Ball\balllo01,PG,23,NOP,48,48,1506,248,587,.422,146,382,.382,102,205,.498,.547,39,50,.780,26,185,211,278,70,28,102,92,681
28,Mo Bamba\bambamo01,C,22,ORL,38,1,526,108,223,.484,32,89,.360,76,134,.567,.556,27,41,.659,56,130,186,23,9,40,26,68,275
29,Desmond Bane\banede01,SG,22,MEM,57,12,1253,193,410,.471,97,213,.455,96,197,.487,.589,36,43,.837,24,146,170,96,34,11,48,111,519
30,Harrison Barnes\barneha02,PF,28,SAC,58,58,2102,319,642,.497,100,256,.391,219,386,.567,.575,195,235,.830,64,321,385,201,43,11,93,75,933
31,RJ Barrett\barrerj01,SG,20,NYK,63,63,2185,415,925,.449,99,254,.390,316,671,.471,.502,181,244,.742,64,297,361,188,47,17,126,167,1110
32,Will Barton\bartowi01,SF,30,DEN,56,52,1736,259,608,.426,98,257,.381,161,351,.459,.507,95,121,.785,39,187,226,181,50,23,96,95,711
33,Keita Bates-Diop\bateske01,SF,25,SAS,22,0,151,16,42,.381,5,15,.333,11,27,.407,.440,11,15,.733,5,20,25,8,9,2,2,7,48
34,Nicolas Batum\batumni01,SF,32,LAC,60,38,1686,173,377,.459,102,250,.408,71,127,.559,.594,46,54,.852,47,242,289,138,63,32,51,95,494
35,Aron Baynes\baynear01,C,34,TOR,50,31,912,121,281,.431,22,93,.237,99,188,.527,.470,27,37,.730,83,171,254,43,15,20,43,113,291
36,Kent Bazemore\bazemke01,SF,31,GSW,57,8,1032,138,308,.448,60,144,.417,78,164,.476,.545,45,65,.692,24,151,175,90,55,27,66,127,381
37,Darius Bazley\bazleda01,PF,20,OKC,46,46,1440,227,557,.408,69,237,.291,158,320,.494,.469,92,130,.708,36,306,342,74,26,25,97,53,615
38,Bradley Beal\bealbr01,SG,27,WAS,53,53,1889,590,1210,.488,117,334,.350,473,876,.540,.536,362,402,.900,62,191,253,240,62,19,171,124,1659
39,Malik Beasley\beaslma01,SG,24,MIN,37,36,1214,264,600,.440,128,321,.399,136,279,.487,.547,68,80,.850,28,134,162,88,30,7,60,62,724
40,Jordan Bell\belljo01,C,26,WAS,5,1,67,7,20,.350,0,2,.000,7,18,.389,.350,0,0,,6,13,19,5,3,3,3,5,14
41,DeAndre' Bembry\bembrde01,SF,26,TOR,41,11,718,81,154,.526,9,33,.273,72,121,.595,.555,31,45,.689,25,82,107,79,32,14,53,60,202
42,Dāvis Bertāns\bertada01,PF,28,WAS,47,5,1176,157,389,.404,140,350,.400,17,39,.436,.584,81,91,.890,16,127,143,41,27,12,27,113,535
43,Patrick Beverley\beverpa01,PG,32,LAC,31,31,726,82,190,.432,52,125,.416,30,65,.462,.568,33,41,.805,27,84,111,65,26,24,27,97,249
44,Saddiq Bey\beysa01,SF,21,DET,60,43,1550,220,545,.404,139,369,.377,81,176,.460,.531,101,116,.871,35,218,253,74,44,9,48,96,680
45,Tyler Bey\beyty01,SF,22,DAL,12,0,47,6,17,.353,1,3,.333,5,14,.357,.382,3,5,.600,5,8,13,1,0,1,1,5,16
46,Khem Birch\birchkh01,C,28,TOT,57,12,1197,131,272,.482,7,31,.226,124,241,.515,.494,74,104,.712,146,161,307,63,39,41,29,86,343
46,Khem Birch\birchkh01,C,28,ORL,48,5,952,94,209,.450,4,21,.190,90,188,.479,.459,63,85,.741,117,126,243,53,32,28,23,67,255
46,Khem Birch\birchkh01,C,28,TOR,9,7,245,37,63,.587,3,10,.300,34,53,.642,.611,11,19,.579,29,35,64,10,7,13,6,19,88
47,Goga Bitadze\bitadgo01,C,21,IND,37,2,419,70,153,.458,15,56,.268,55,97,.567,.507,34,45,.756,48,71,119,26,8,46,16,71,189
48,Bismack Biyombo\biyombi01,C,28,CHO,56,30,1156,120,209,.574,0,1,.000,120,208,.577,.574,44,94,.468,118,176,294,71,15,61,59,122,284
49,Nemanja Bjelica\bjeline01,PF,32,TOT,35,1,537,78,175,.446,20,74,.270,58,101,.574,.503,34,47,.723,25,92,117,59,11,4,31,64,210
49,Nemanja Bjelica\bjeline01,PF,32,SAC,26,1,439,69,150,.460,17,58,.293,52,92,.565,.517,32,42,.762,24,76,100,49,8,2,28,48,187
49,Nemanja Bjelica\bjeline01,PF,32,MIA,9,0,98,9,25,.360,3,16,.188,6,9,.667,.420,2,5,.400,1,16,17,10,3,2,3,16,23
50,Eric Bledsoe\bledser01,SG,31,NOP,61,60,1814,255,616,.414,109,311,.350,146,305,.479,.502,110,154,.714,26,181,207,223,48,17,99,100,729
51,Keljin Blevins\blevike01,SF,25,POR,12,0,60,3,17,.176,1,6,.167,2,11,.182,.206,0,0,,2,3,5,4,2,0,3,6,7
52,Bogdan Bogdanović\bogdabo01,SG,28,ATL,37,20,1072,210,460,.457,111,265,.419,99,195,.508,.577,33,37,.892,17,121,138,119,36,9,48,82,564
53,Bojan Bogdanović\bogdabo02,SF,31,UTA,62,62,1892,318,757,.420,150,394,.381,168,363,.463,.519,187,214,.874,33,204,237,117,37,4,96,98,973
54,Bol Bol\bolbo01,PF,21,DEN,27,2,128,24,47,.511,9,20,.450,15,27,.556,.606,9,14,.643,0,18,18,7,3,10,12,12,66
55,Marques Bolden\boldema01,C,22,CLE,6,0,29,1,3,.333,0,0,,1,3,.333,.333,5,8,.625,3,3,6,0,2,2,2,0,7
56,Jordan Bone\bonejo01,PG,23,ORL,14,0,196,23,54,.426,10,32,.313,13,22,.591,.519,0,0,,4,20,24,18,2,0,3,11,56
57,Isaac Bonga\bongais01,SF,21,WAS,38,8,419,30,79,.380,13,46,.283,17,33,.515,.462,5,8,.625,18,47,65,22,11,8,21,59,78
58,Devin Booker\bookede01,SG,24,PHO,58,58,1962,540,1117,.483,113,328,.345,427,789,.541,.534,279,326,.856,27,215,242,257,49,16,186,160,1472
59,Chris Boucher\bouchch01,C,28,TOR,59,13,1415,283,545,.519,88,226,.389,195,319,.611,.600,148,188,.787,116,281,397,63,34,110,46,164,802
60,Brian Bowen\bowenbr02,SF,22,IND,6,0,15,1,4,.250,0,1,.000,1,3,.333,.250,1,1,1.000,0,3,3,0,0,0,0,1,3
61,Avery Bradley\bradlav01,SG,30,TOT,25,4,556,60,160,.375,32,96,.333,28,64,.438,.475,12,15,.800,7,46,53,43,19,3,25,53,164
61,Avery Bradley\bradlav01,SG,30,MIA,10,1,211,31,66,.470,16,38,.421,15,28,.536,.591,7,9,.778,2,16,18,14,7,1,9,26,85
61,Avery Bradley\bradlav01,SG,30,HOU,15,3,345,29,94,.309,16,58,.276,13,36,.361,.394,5,6,.833,5,30,35,29,12,2,16,27,79
62,Tony Bradley\bradlto01,C,23,TOT,36,8,582,110,167,.659,0,3,.000,110,164,.671,.659,31,45,.689,74,128,202,30,14,24,28,54,251
62,Tony Bradley\bradlto01,C,23,PHI,20,8,287,51,75,.680,0,1,.000,51,74,.689,.680,7,11,.636,39,65,104,17,6,13,6,28,109
62,Tony Bradley\bradlto01,C,23,OKC,16,0,295,59,92,.641,0,2,.000,59,90,.656,.641,24,34,.706,35,63,98,13,8,11,22,26,142
63,Jarrell Brantley\brantja01,PF,24,UTA,22,0,106,20,39,.513,10,23,.435,10,16,.625,.641,2,2,1.000,6,17,23,9,4,2,5,16,52
64,Ignas Brazdeikis\brazdig01,SF,22,TOT,5,0,15,0,4,.000,0,1,.000,0,3,.000,.000,2,2,1.000,1,3,4,1,0,0,1,0,2
64,Ignas Brazdeikis\brazdig01,SF,22,NYK,4,0,7,0,1,.000,0,0,,0,1,.000,.000,2,2,1.000,1,1,2,1,0,0,1,0,2
64,Ignas Brazdeikis\brazdig01,SF,22,PHI,1,0,8,0,3,.000,0,1,.000,0,2,.000,.000,0,0,,0,2,2,0,0,0,0,0,0
65,Mikal Bridges\bridgmi01,SF,24,PHO,62,62,2031,305,578,.528,109,272,.401,196,306,.641,.622,93,113,.823,68,207,275,135,61,53,51,100,812
66,Miles Bridges\bridgmi02,PF,22,CHO,62,16,1791,280,555,.505,106,259,.409,174,296,.588,.600,85,99,.859,76,301,377,134,42,47,100,132,751
67,Amida Brimah\brimaam01,C,26,IND,2,0,14,2,3,.667,0,0,,2,3,.667,.667,2,2,1.000,0,3,3,0,0,3,0,1,6
68,Oshae Brissett\brissos01,SF,22,IND,10,5,200,30,58,.517,14,31,.452,16,27,.593,.638,20,27,.741,14,35,49,6,6,10,3,11,94
69,Malcolm Brogdon\brogdma01,PG,28,IND,55,55,1918,444,975,.455,145,371,.391,299,604,.495,.530,152,175,.869,58,232,290,327,49,15,114,110,1185
70,Armoni Brooks\brookar01,SG,22,HOU,10,3,223,26,71,.366,21,61,.344,5,10,.500,.514,2,5,.400,5,31,36,13,4,1,12,14,75
71,Dillon Brooks\brookdi01,SF,25,MEM,57,57,1668,357,851,.420,106,307,.345,251,544,.461,.482,131,155,.845,46,123,169,132,67,22,106,200,951
72,Bruce Brown\brownbr01,PG,24,BRK,57,32,1274,203,372,.546,16,55,.291,187,317,.590,.567,78,106,.736,97,200,297,90,53,21,49,130,500
73,Charlie Brown\brownch02,SG,23,OKC,1,0,12,1,4,.250,1,3,.333,0,1,.000,.375,2,2,1.000,0,0,0,0,2,0,0,1,5
74,Jaylen Brown\brownja02,SG,24,BOS,56,56,1920,527,1065,.495,158,390,.405,369,675,.547,.569,185,241,.768,67,264,331,189,70,30,151,161,1397
75,Moses Brown\brownmo01,C,21,OKC,33,22,668,109,198,.551,0,0,,109,198,.551,.551,62,98,.633,108,164,272,6,21,33,34,69,280
76,Sterling Brown\brownst02,SG,25,HOU,51,14,1229,150,335,.448,91,215,.423,59,120,.492,.584,25,31,.806,38,186,224,72,38,12,41,97,416
77,Troy Brown Jr.\browntr01,SF,21,TOT,34,0,524,62,144,.431,22,70,.314,40,74,.541,.507,15,21,.714,20,85,105,29,10,6,21,49,161
77,Troy Brown Jr.\browntr01,SF,21,WAS,21,0,287,33,89,.371,14,46,.304,19,43,.442,.449,10,15,.667,11,50,61,19,3,4,16,29,90
77,Troy Brown Jr.\browntr01,SF,21,CHI,13,0,237,29,55,.527,8,24,.333,21,31,.677,.600,5,6,.833,9,35,44,10,7,2,5,20,71
78,Jalen Brunson\brunsja01,PG,24,DAL,57,11,1439,271,519,.522,65,167,.389,206,352,.585,.585,107,136,.787,26,178,204,197,29,0,70,92,714
79,Thomas Bryant\bryanth01,C,23,WAS,10,10,271,59,91,.648,9,21,.429,50,70,.714,.698,16,24,.667,18,43,61,15,4,8,11,31,143
80,Reggie Bullock\bullore01,SF,29,NYK,56,55,1623,208,469,.443,136,330,.412,72,139,.518,.588,37,42,.881,13,175,188,83,43,9,39,124,589
81,Trey Burke\burketr01,PG,28,DAL,51,1,760,128,293,.437,51,138,.370,77,155,.497,.524,37,43,.860,6,39,45,73,33,4,26,52,344
82,Alec Burks\burksal01,SG,29,NYK,44,5,1134,184,444,.414,89,218,.408,95,226,.420,.515,96,111,.865,19,179,198,96,30,12,44,91,553
83,Jimmy Butler\butleji01,SF,31,MIA,46,46,1564,331,671,.493,19,90,.211,312,581,.537,.507,317,367,.864,84,240,324,333,97,17,100,66,998
84,Bruno Caboclo\cabocbr01,PF,25,HOU,6,0,36,8,17,.471,0,5,.000,8,12,.667,.471,1,2,.500,3,11,14,1,0,2,4,6,17
85,Devontae Cacok\cacokde01,PF,24,LAL,18,1,90,17,27,.630,0,0,,17,27,.630,.630,4,9,.444,10,20,30,1,5,4,5,8,38
86,Kentavious Caldwell-Pope\caldwke01,SG,27,LAL,57,57,1575,185,430,.430,103,246,.419,82,184,.446,.550,73,85,.859,23,128,151,94,48,20,56,94,546
87,Facundo Campazzo\campafa01,PG,29,DEN,56,10,1143,96,249,.386,65,175,.371,31,74,.419,.516,53,62,.855,17,80,97,182,60,12,58,116,310
88,Vlatko Čančar\cancavl01,PF,23,DEN,34,0,184,18,43,.419,5,22,.227,13,21,.619,.477,7,8,.875,6,30,36,10,9,2,12,14,48
89,Devin Cannady\cannade01,PG,24,ORL,8,0,74,11,28,.393,6,16,.375,5,12,.417,.500,6,7,.857,0,5,5,1,5,1,2,9,34
90,Clint Capela\capelca01,C,26,ATL,55,55,1673,366,621,.589,0,0,,366,621,.589,.589,113,196,.577,267,534,801,45,39,117,65,124,845
91,Vernon Carey Jr.\careyve01,C,19,CHO,15,4,95,14,28,.500,1,7,.143,13,21,.619,.518,8,9,.889,3,18,21,2,1,4,5,11,37
92,Jevon Carter\carteje01,PG,25,PHO,50,0,553,71,171,.415,45,122,.369,26,49,.531,.547,2,4,.500,12,59,71,54,20,9,12,51,189
93,Wendell Carter Jr.\cartewe01,C,21,TOT,48,38,1227,213,406,.525,14,42,.333,199,364,.547,.542,121,166,.729,115,278,393,95,34,39,71,136,561
93,Wendell Carter Jr.\cartewe01,C,21,CHI,32,25,792,129,252,.512,8,22,.364,121,230,.526,.528,82,111,.739,70,180,250,69,18,24,49,96,348
93,Wendell Carter Jr.\cartewe01,C,21,ORL,16,13,435,84,154,.545,6,20,.300,78,134,.582,.565,39,55,.709,45,98,143,26,16,15,22,40,213
94,Michael Carter-Williams\cartemi01,SG,29,ORL,31,25,800,105,270,.389,15,61,.246,90,209,.431,.417,49,80,.613,39,100,139,129,25,17,69,81,274
95,Alex Caruso\carusal01,PG,26,LAL,51,0,1041,105,243,.432,47,116,.405,58,127,.457,.529,43,63,.683,26,121,147,128,58,13,62,92,300
96,Willie Cauley-Stein\caulewi01,C,27,DAL,42,11,728,96,152,.632,1,9,.111,95,143,.664,.635,44,70,.629,51,130,181,29,15,34,20,97,237
97,Chris Chiozza\chiozch01,PG,25,BRK,22,1,232,31,88,.352,13,42,.310,18,46,.391,.426,13,17,.765,3,21,24,65,7,6,16,19,88
98,Marquese Chriss\chrisma01,PF,23,GSW,2,0,27,5,14,.357,1,5,.200,4,9,.444,.393,2,4,.500,3,10,13,2,0,2,2,3,13
99,Gary Clark\clarkga01,SF,26,TOT,37,11,641,40,131,.305,31,108,.287,9,23,.391,.424,8,10,.800,33,80,113,30,12,7,17,34,119
99,Gary Clark\clarkga01,SF,26,ORL,35,11,637,40,131,.305,31,108,.287,9,23,.391,.424,8,10,.800,33,79,112,30,12,7,17,34,119
99,Gary Clark\clarkga01,SF,26,DEN,2,0,4,0,0,,0,0,,0,0,,,0,0,,0,1,1,0,0,0,0,0,0
100,Brandon Clarke\clarkbr01,PF,24,MEM,51,16,1264,228,442,.516,19,67,.284,209,375,.557,.537,66,97,.680,76,206,282,87,52,43,31,73,541
101,Jordan Clarkson\clarkjo01,SG,28,UTA,58,1,1509,370,880,.420,175,504,.347,195,376,.519,.520,100,108,.926,42,188,230,131,50,9,97,89,1015
102,Nicolas Claxton\claxtni01,C,21,BRK,25,1,462,70,120,.583,1,5,.200,69,115,.600,.588,23,46,.500,35,89,124,27,19,30,14,52,164
103,Amir Coffey\coffeam01,SG,23,LAC,44,1,394,45,103,.437,23,56,.411,22,47,.468,.549,27,38,.711,10,34,44,22,10,0,15,30,140
104,John Collins\collijo01,PF,23,ATL,54,54,1615,377,681,.554,66,173,.382,311,508,.612,.602,145,174,.833,109,301,410,73,27,53,68,167,965
105,Mike Conley\conlemi01,PG,33,UTA,49,49,1459,278,623,.446,134,329,.407,144,294,.490,.554,116,136,.853,35,134,169,293,67,9,98,94,806
106,Pat Connaughton\connapa01,SG,28,MIL,58,3,1332,147,328,.448,87,226,.385,60,102,.588,.581,26,35,.743,56,221,277,70,39,20,28,89,407
107,Quinn Cook\cookqu01,PG,27,TOT,23,0,157,29,68,.426,11,26,.423,18,42,.429,.507,7,8,.875,2,15,17,18,4,1,7,10,76
107,Quinn Cook\cookqu01,PG,27,LAL,16,0,62,12,26,.462,5,13,.385,7,13,.538,.558,4,5,.800,0,5,5,5,1,1,3,2,33
107,Quinn Cook\cookqu01,PG,27,CLE,7,0,95,17,42,.405,6,13,.462,11,29,.379,.476,3,3,1.000,2,10,12,13,3,0,4,8,43
108,Tyler Cook\cookty01,SF-PF,23,TOT,22,1,255,34,57,.596,0,1,.000,34,56,.607,.596,9,19,.474,17,38,55,11,5,0,16,22,77
108,Tyler Cook\cookty01,PF,23,BRK,4,0,17,1,3,.333,0,0,,1,3,.333,.333,0,0,,1,1,2,2,0,0,1,2,2
108,Tyler Cook\cookty01,SF,23,DET,18,1,238,33,54,.611,0,1,.000,33,53,.623,.611,9,19,.474,16,37,53,9,5,0,15,20,75
109,DeMarcus Cousins\couside01,C,30,TOT,34,11,622,105,265,.396,43,127,.339,62,138,.449,.477,54,76,.711,46,192,238,71,24,21,58,91,307
109,DeMarcus Cousins\couside01,C,30,HOU,25,11,506,79,210,.376,39,116,.336,40,94,.426,.469,44,59,.746,30,161,191,60,21,18,39,74,241
109,DeMarcus Cousins\couside01,C,30,LAC,9,0,116,26,55,.473,4,11,.364,22,44,.500,.509,10,17,.588,16,31,47,11,3,3,19,17,66
110,Robert Covington\covinro01,PF,30,POR,60,60,1929,181,448,.404,116,306,.379,65,142,.458,.533,44,53,.830,53,351,404,101,88,74,62,164,522
111,Torrey Craig\craigto01,SF,30,TOT,40,2,589,77,160,.481,29,75,.387,48,85,.565,.572,12,16,.750,42,104,146,37,23,18,20,61,195
111,Torrey Craig\craigto01,SF,30,MIL,18,0,201,18,46,.391,8,22,.364,10,24,.417,.478,1,2,.500,13,30,43,16,9,7,5,24,45
111,Torrey Craig\craigto01,SF,30,PHO,22,2,388,59,114,.518,21,53,.396,38,61,.623,.610,11,14,.786,29,74,103,21,14,11,15,37,150
112,Jae Crowder\crowdja01,PF,30,PHO,55,39,1508,179,446,.401,130,341,.381,49,105,.467,.547,51,67,.761,30,236,266,118,44,23,52,108,539
113,Jarrett Culver\culveja01,SG,21,MIN,34,7,499,69,168,.411,13,53,.245,56,115,.487,.449,29,48,.604,34,70,104,24,17,9,28,58,180
114,Seth Curry\curryse01,SG,30,PHI,49,49,1407,218,481,.453,101,237,.426,117,244,.480,.558,60,67,.896,10,92,102,133,38,8,58,80,597
115,Stephen Curry\curryst01,PG,32,GSW,54,54,1838,552,1128,.489,278,649,.428,274,479,.572,.613,302,329,.918,24,274,298,310,64,7,181,99,1684
116,Nate Darling\darlina01,SG,22,CHO,6,0,24,2,7,.286,2,7,.286,0,0,,.429,3,3,1.000,1,0,1,1,0,1,1,1,9
117,Anthony Davis\davisan02,PF,27,LAL,27,27,862,229,447,.512,20,74,.270,209,373,.560,.535,105,148,.709,51,162,213,79,35,46,55,48,583
118,Ed Davis\davised01,C,31,MIN,22,7,293,19,44,.432,0,0,,19,44,.432,.432,10,12,.833,46,67,113,21,13,13,7,54,48
119,Terence Davis\daviste02,SG,23,TOT,51,4,797,137,325,.422,70,192,.365,67,133,.504,.529,25,31,.806,13,95,108,55,28,11,47,71,369
119,Terence Davis\daviste02,SG,23,TOR,34,4,493,87,210,.414,44,122,.361,43,88,.489,.519,16,18,.889,9,57,66,37,17,7,29,48,234
119,Terence Davis\daviste02,SG,23,SAC,17,0,304,50,115,.435,26,70,.371,24,45,.533,.548,9,13,.692,4,38,42,18,11,4,18,23,135
120,Dewayne Dedmon\dedmode01,C,31,MIA,8,0,107,26,35,.743,0,3,.000,26,32,.813,.743,15,17,.882,16,31,47,3,5,5,7,14,67
121,Matthew Dellavedova\dellama01,PG,30,CLE,13,1,224,14,56,.250,4,25,.160,10,31,.323,.286,4,4,1.000,6,18,24,58,4,1,6,21,36
122,DeMar DeRozan\derozde01,PF,31,SAS,52,52,1774,386,782,.494,18,71,.254,368,711,.518,.505,329,371,.887,39,189,228,376,45,13,102,108,1119
123,Mamadi Diakite\diakima01,PF,24,MIL,12,0,102,12,29,.414,1,7,.143,11,22,.500,.431,6,6,1.000,6,21,27,6,4,5,3,12,31
124,Hamidou Diallo\diallha01,SG-SF,22,TOT,47,5,1066,190,406,.468,21,62,.339,169,344,.491,.494,109,170,.641,55,176,231,94,39,20,68,121,510
124,Hamidou Diallo\diallha01,SG,22,OKC,32,5,761,143,297,.481,12,41,.293,131,256,.512,.502,83,132,.629,37,128,165,77,31,12,49,83,381
124,Hamidou Diallo\diallha01,SF,22,DET,15,0,305,47,109,.431,9,21,.429,38,88,.432,.472,26,38,.684,18,48,66,17,8,8,19,38,129
125,Gorgui Dieng\dienggo01,C,31,TOT,30,1,436,62,121,.512,25,55,.455,37,66,.561,.616,46,54,.852,33,83,116,33,19,15,25,48,195
125,Gorgui Dieng\dienggo01,C,31,MEM,22,1,371,56,108,.519,23,48,.479,33,60,.550,.625,38,43,.884,28,70,98,29,17,14,22,38,173
125,Gorgui Dieng\dienggo01,C,31,SAS,8,0,65,6,13,.462,2,7,.286,4,6,.667,.538,8,11,.727,5,13,18,4,2,1,3,10,22
126,Spencer Dinwiddie\dinwisp01,SG,27,BRK,3,3,64,6,16,.375,2,7,.286,4,9,.444,.438,6,6,1.000,0,13,13,9,2,1,5,4,20
127,Donte DiVincenzo\divindo01,SG,24,MIL,57,57,1566,218,525,.415,110,292,.377,108,233,.464,.520,42,57,.737,71,245,316,176,66,12,82,92,588
128,Luka Dončić\doncilu01,PG,21,DAL,56,56,1964,567,1169,.485,169,471,.359,398,698,.570,.557,297,407,.730,45,400,445,489,56,34,243,130,1600
129,Luguentz Dort\dortlu01,SG,21,OKC,47,47,1401,227,566,.401,101,291,.347,126,275,.458,.490,114,152,.750,33,142,175,75,44,19,71,120,669
130,Damyean Dotson\dotsoda01,SG,26,CLE,37,6,700,94,236,.398,36,124,.290,58,112,.518,.475,23,34,.676,5,71,76,78,14,4,30,34,247
131,Devon Dotson\dotsode01,PG,21,CHI,6,0,22,3,7,.429,0,1,.000,3,6,.500,.429,0,0,,2,1,3,2,1,0,0,1,6
132,Sekou Doumbouya\doumbse01,PF,20,DET,48,4,644,70,202,.347,22,90,.244,48,112,.429,.401,31,42,.738,25,79,104,35,20,5,35,74,193
133,PJ Dozier\doziepj01,SG,24,DEN,47,3,1005,136,322,.422,44,135,.326,92,187,.492,.491,40,64,.625,34,140,174,87,31,21,42,80,356
134,Goran Dragić\dragigo01,PG,34,MIA,42,11,1114,194,446,.435,70,196,.357,124,250,.496,.513,87,106,.821,19,126,145,189,30,7,99,93,545
135,Andre Drummond\drumman01,C,27,TOT,36,36,999,233,482,.483,0,8,.000,233,474,.492,.483,102,168,.607,131,321,452,83,57,39,107,109,568
135,Andre Drummond\drumman01,C,27,CLE,25,25,722,180,380,.474,0,8,.000,180,372,.484,.474,77,129,.597,101,236,337,64,40,29,81,69,437
135,Andre Drummond\drumman01,C,27,LAL,11,11,277,53,102,.520,0,0,,53,102,.520,.520,25,39,.641,30,85,115,19,17,10,26,40,131
136,Jared Dudley\dudleja01,PF,35,LAL,11,0,76,2,7,.286,2,5,.400,0,2,.000,.429,0,0,,4,15,19,5,1,1,2,7,6
137,Kris Dunn\dunnkr01,PG,26,ATL,2,0,28,1,11,.091,0,2,.000,1,9,.111,.091,3,4,.750,0,3,3,1,1,1,2,8,5
138,Kevin Durant\duranke01,PF,32,BRK,26,23,845,240,439,.547,66,140,.471,174,299,.582,.622,158,181,.873,9,168,177,133,18,34,93,50,704
139,Anthony Edwards\edwaran01,SG,19,MIN,63,46,1987,419,1048,.400,142,450,.316,277,598,.463,.468,171,221,.774,51,236,287,170,76,27,135,104,1151
140,Carsen Edwards\edwarca01,SG,22,BOS,25,1,212,39,86,.453,13,46,.283,26,40,.650,.529,7,9,.778,3,19,22,11,5,1,4,22,98
141,CJ Elleby\ellebcj01,SF,20,POR,23,0,164,20,53,.377,6,29,.207,14,24,.583,.434,9,13,.692,10,15,25,6,6,3,5,23,55
142,Henry Ellenson\ellenhe01,PF,24,TOR,2,0,38,5,14,.357,2,9,.222,3,5,.600,.429,3,4,.750,3,9,12,5,0,0,0,7,15
143,Wayne Ellington\ellinwa01,SG,33,DET,44,30,962,142,319,.445,109,259,.421,33,60,.550,.616,28,35,.800,12,70,82,63,17,9,29,59,421
144,Joel Embiid\embiijo01,C,26,PHI,43,43,1364,400,781,.512,51,136,.375,349,645,.541,.545,416,489,.851,97,370,467,131,45,61,133,103,1267
145,James Ennis\ennisja01,SF,30,ORL,40,36,970,114,240,.475,45,102,.441,69,138,.500,.569,69,85,.812,43,123,166,61,32,7,36,82,342
146,Drew Eubanks\eubandr01,C,23,SAS,43,1,596,89,156,.571,1,1,1.000,88,155,.568,.574,60,87,.690,51,131,182,36,17,42,37,66,239
147,Dante Exum\exumda01,SG,25,CLE,6,3,116,10,26,.385,2,11,.182,8,15,.533,.423,1,2,.500,2,15,17,13,4,2,7,9,23
148,Tacko Fall\fallta01,C,25,BOS,15,0,100,18,24,.750,0,0,,18,24,.750,.750,4,13,.308,11,27,38,2,1,12,4,16,40
149,Derrick Favors\favorde01,C,29,UTA,58,0,892,132,212,.623,0,2,.000,132,210,.629,.623,54,73,.740,123,199,322,40,29,61,34,129,318
150,Cristiano Felício\feliccr01,C,28,CHI,14,0,59,4,7,.571,0,1,.000,4,6,.667,.571,6,10,.600,6,8,14,8,2,0,4,7,14
151,Terrance Ferguson\fergute01,SG,22,PHI,13,0,49,1,7,.143,0,5,.000,1,2,.500,.143,0,0,,0,1,1,2,1,0,4,7,2
152,Bruno Fernando\fernabr01,C,22,ATL,29,0,191,12,31,.387,0,2,.000,12,29,.414,.387,12,18,.667,14,53,67,9,2,3,20,20,36
153,Yogi Ferrell\ferreyo01,PG,27,TOT,5,0,69,12,31,.387,6,15,.400,6,16,.375,.484,3,5,.600,3,5,8,15,4,1,3,5,33
153,Yogi Ferrell\ferreyo01,PG,27,CLE,2,0,40,8,21,.381,3,9,.333,5,12,.417,.452,0,2,.000,3,4,7,5,3,1,3,4,19
153,Yogi Ferrell\ferreyo01,PG,27,LAC,3,0,29,4,10,.400,3,6,.500,1,4,.250,.550,3,3,1.000,0,1,1,10,1,0,0,1,14
154,Dorian Finney-Smith\finnedo01,PF,27,DAL,50,50,1613,179,387,.463,99,252,.393,80,135,.593,.590,27,33,.818,87,194,281,79,46,22,31,119,484
155,Malik Fitts\fittsma01,PF,23,LAC,3,0,11,1,3,.333,1,2,.500,0,1,.000,.500,0,0,,0,3,3,0,0,0,0,3,3
156,Malachi Flynn\flynnma01,PG,22,TOR,37,6,631,81,220,.368,34,107,.318,47,113,.416,.445,31,38,.816,8,68,76,98,28,5,28,44,227
157,Bryn Forbes\forbebr01,SG,27,MIL,60,9,1144,204,446,.457,125,288,.434,79,158,.500,.598,40,52,.769,10,77,87,37,20,0,35,63,573
158,Trent Forrest\forretr01,PG,22,UTA,20,0,130,11,24,.458,1,5,.200,10,19,.526,.479,4,4,1.000,0,10,10,26,4,1,9,7,27
159,Evan Fournier\fournev01,SF-SG,28,TOT,34,28,1010,191,438,.436,86,228,.377,105,210,.500,.534,104,131,.794,7,91,98,111,38,14,64,74,572
159,Evan Fournier\fournev01,SF,28,ORL,26,26,787,170,369,.461,73,188,.388,97,181,.536,.560,98,123,.797,5,70,75,95,27,9,54,55,511
159,Evan Fournier\fournev01,SG,28,BOS,8,2,223,21,69,.304,13,40,.325,8,29,.276,.399,6,8,.750,2,21,23,16,11,5,10,19,61
160,De'Aaron Fox\foxde01,PG,23,SAC,58,58,2036,529,1110,.477,103,320,.322,426,790,.539,.523,300,417,.719,33,170,203,417,87,27,174,170,1461
161,Robert Franks\frankro01,PF,24,ORL,7,0,101,13,28,.464,5,15,.333,8,13,.615,.554,12,13,.923,6,8,14,5,3,3,2,8,43
162,Tim Frazier\fraziti01,PG,30,MEM,3,0,33,2,8,.250,0,2,.000,2,6,.333,.250,0,0,,0,4,4,7,1,0,3,4,4
163,Markelle Fultz\fultzma01,PG,22,ORL,8,8,215,41,104,.394,4,16,.250,37,88,.420,.413,17,19,.895,5,20,25,43,8,2,18,18,103
164,Wenyen Gabriel\gabriwe01,PF,23,NOP,12,0,97,8,22,.364,4,10,.400,4,12,.333,.455,4,7,.571,8,12,20,8,4,2,9,11,24
165,Daniel Gafford\gaffoda01,PF-C,22,TOT,44,11,614,116,172,.674,0,0,,116,172,.674,.674,53,83,.639,72,109,181,23,21,60,34,77,285
165,Daniel Gafford\gaffoda01,PF,22,CHI,31,11,383,60,87,.690,0,0,,60,87,.690,.690,27,41,.659,44,59,103,17,11,34,22,54,147
165,Daniel Gafford\gaffoda01,C,22,WAS,13,0,231,56,85,.659,0,0,,56,85,.659,.659,26,42,.619,28,50,78,6,10,26,12,23,138
166,Danilo Gallinari\gallida01,PF,32,ATL,43,4,1023,168,401,.419,87,218,.399,81,183,.443,.527,147,157,.936,15,158,173,60,22,7,39,88,570
167,Langston Galloway\gallola01,SG,29,PHO,35,0,381,57,122,.467,32,71,.451,25,51,.490,.598,17,17,1.000,5,30,35,24,8,0,12,23,163
168,Darius Garland\garlada01,PG,21,CLE,52,49,1758,356,788,.452,104,260,.400,252,528,.477,.518,110,130,.846,23,104,127,324,65,6,160,110,926
169,Marc Gasol\gasolma01,C,36,LAL,45,42,878,80,180,.444,43,111,.387,37,69,.536,.564,34,46,.739,35,150,185,94,23,54,52,101,237
170,Rudy Gay\gayru01,PF,34,SAS,53,0,1149,218,523,.417,86,226,.381,132,297,.444,.499,69,87,.793,37,219,256,77,36,31,53,98,591
171,Paul George\georgpa01,SF,30,LAC,48,48,1608,404,850,.475,154,365,.422,250,485,.515,.566,177,200,.885,42,272,314,255,59,22,161,118,1139
172,Taj Gibson\gibsota01,PF,35,NYK,36,2,728,76,122,.623,3,14,.214,73,108,.676,.635,31,45,.689,80,117,197,26,28,34,20,76,186
173,Harry Giles\gilesha01,C,22,POR,32,0,321,34,82,.415,8,18,.444,26,64,.406,.463,15,22,.682,29,92,121,24,6,10,19,52,91
174,Shai Gilgeous-Alexander\gilgesh01,SG,22,OKC,35,35,1180,287,565,.508,71,170,.418,216,395,.547,.571,185,229,.808,19,147,166,207,27,23,106,70,830
175,Anthony Gill\gillan01,PF,28,WAS,21,2,144,19,37,.514,5,18,.278,14,19,.737,.581,4,6,.667,13,28,41,6,6,3,6,17,47
176,Freddie Gillespie\gillefr01,PF,23,TOR,10,0,160,21,35,.600,0,0,,21,35,.600,.600,11,12,.917,16,20,36,5,4,10,6,23,53
177,Rudy Gobert\goberru01,C,28,UTA,61,61,1891,337,498,.677,0,3,.000,337,495,.681,.677,205,331,.619,204,615,819,78,33,173,98,145,879
178,Brandon Goodwin\goodwbr01,PG,25,ATL,44,5,600,80,216,.370,31,101,.307,49,115,.426,.442,27,41,.659,8,58,66,90,15,0,34,37,218
179,Aaron Gordon\gordoaa01,PF,25,TOT,42,42,1184,203,435,.467,57,160,.356,146,275,.531,.532,90,138,.652,62,186,248,145,29,29,89,78,553
179,Aaron Gordon\gordoaa01,PF,25,ORL,25,25,736,128,293,.437,42,112,.375,86,181,.475,.509,66,105,.629,39,127,166,105,16,20,67,49,364
179,Aaron Gordon\gordoaa01,PF,25,DEN,17,17,448,75,142,.528,15,48,.313,60,94,.638,.581,24,33,.727,23,59,82,40,13,9,22,29,189
180,Eric Gordon\gordoer01,SG,32,HOU,27,13,789,159,367,.433,69,210,.329,90,157,.573,.527,94,114,.825,8,50,58,71,14,13,51,44,481
181,Devonte' Graham\grahade01,PG,25,CHO,50,44,1507,229,612,.374,162,433,.374,67,179,.374,.507,111,136,.816,19,116,135,270,47,6,79,73,731
182,Jerami Grant\grantje01,SF,26,DET,53,53,1805,395,922,.428,115,325,.354,280,597,.469,.491,286,337,.849,35,211,246,151,35,56,106,124,1191
183,Danny Green\greenda02,SF,33,PHI,60,60,1694,196,467,.420,152,368,.413,44,99,.444,.582,27,35,.771,50,173,223,103,80,51,61,111,571
184,Draymond Green\greendr01,PF,30,GSW,54,54,1668,135,321,.421,27,110,.245,108,211,.512,.463,53,68,.779,47,322,369,469,88,42,163,169,350
185,JaMychal Green\greenja01,PF,30,DEN,48,4,897,143,304,.470,66,161,.410,77,143,.538,.579,38,45,.844,70,163,233,36,24,17,44,121,390
186,Javonte Green\greenja02,SG-PG,27,TOT,32,2,379,40,79,.506,7,23,.304,33,56,.589,.551,22,32,.688,22,37,59,13,20,4,17,35,109
186,Javonte Green\greenja02,SG,27,BOS,25,2,345,39,71,.549,7,22,.318,32,49,.653,.599,20,30,.667,20,32,52,11,18,2,13,32,105
186,Javonte Green\greenja02,PG,27,CHI,7,0,34,1,8,.125,0,1,.000,1,7,.143,.125,2,2,1.000,2,5,7,2,2,2,4,3,4
187,Jeff Green\greenje02,C,34,BRK,58,34,1575,216,454,.476,81,211,.384,135,243,.556,.565,102,130,.785,28,193,221,95,33,25,46,105,615
188,Josh Green\greenjo02,SG,20,DAL,30,5,310,28,65,.431,3,18,.167,25,47,.532,.454,9,15,.600,19,38,57,16,8,3,16,21,68
189,Blake Griffin\griffbl01,PF,31,TOT,36,23,963,135,331,.408,56,169,.331,79,162,.488,.492,76,103,.738,22,157,179,116,28,11,53,84,402
189,Blake Griffin\griffbl01,PF,31,DET,20,20,626,81,222,.365,39,124,.315,42,98,.429,.453,44,62,.710,7,97,104,77,14,2,32,42,245
189,Blake Griffin\griffbl01,PF,31,BRK,16,3,337,54,109,.495,17,45,.378,37,64,.578,.573,32,41,.780,15,60,75,39,14,9,21,42,157
190,Kyle Guy\guyky01,PG,23,SAC,25,0,176,25,68,.368,10,36,.278,15,32,.469,.441,14,16,.875,4,21,25,21,4,0,6,15,74
191,Rui Hachimura\hachiru01,PF,22,WAS,49,49,1553,254,540,.470,38,119,.319,216,421,.513,.506,113,147,.769,42,232,274,74,41,5,61,107,659
192,Ashton Hagans\haganas01,PG,21,MIN,2,0,4,0,0,,0,0,,0,0,,,0,0,,0,0,0,0,0,0,1,0,0
193,Tyrese Haliburton\halibty01,PG,20,SAC,56,18,1684,280,597,.469,115,284,.405,165,313,.527,.565,44,52,.846,38,129,167,294,74,27,86,83,719
194,Donta Hall\halldo01,PF,23,ORL,6,0,61,7,10,.700,0,0,,7,10,.700,.700,7,11,.636,10,10,20,6,3,6,2,4,21
195,Josh Hall\halljo01,SF,20,OKC,14,0,174,9,45,.200,2,20,.100,7,25,.280,.222,17,29,.586,1,27,28,18,0,0,16,21,37
196,R.J. Hampton\hamptrj01,PG-SG,19,TOT,42,1,624,85,200,.425,16,60,.267,69,140,.493,.465,29,45,.644,20,98,118,41,18,6,36,51,215
196,R.J. Hampton\hamptrj01,PG,19,DEN,25,0,233,25,60,.417,5,18,.278,20,42,.476,.458,9,12,.750,10,40,50,14,5,2,11,22,64
196,R.J. Hampton\hamptrj01,SG,19,ORL,17,1,391,60,140,.429,11,42,.262,49,98,.500,.468,20,33,.606,10,58,68,27,13,4,25,29,151
197,Tim Hardaway Jr.\hardati02,SG,28,DAL,60,22,1690,328,762,.430,166,441,.376,162,321,.505,.539,111,140,.793,17,184,201,99,25,9,55,92,933
198,James Harden\hardeja01,PG-SG,31,TOT,42,42,1558,334,722,.463,117,327,.358,217,395,.549,.544,275,316,.870,35,301,336,457,50,29,173,95,1060
198,James Harden\hardeja01,SG,31,HOU,8,8,290,60,135,.444,25,72,.347,35,63,.556,.537,53,60,.883,5,36,41,83,7,6,34,14,198
198,James Harden\hardeja01,PG,31,BRK,34,34,1268,274,587,.467,92,255,.361,182,332,.548,.545,222,256,.867,30,265,295,374,43,23,139,81,862
199,Maurice Harkless\harklma01,PF-SF,27,TOT,28,14,530,42,100,.420,16,53,.302,26,47,.553,.500,21,26,.808,10,49,59,27,19,15,14,60,121
199,Maurice Harkless\harklma01,SF,27,MIA,11,3,124,5,13,.385,5,11,.455,0,2,.000,.577,0,2,.000,2,11,13,7,2,4,3,14,15
199,Maurice Harkless\harklma01,PF,27,SAC,17,11,406,37,87,.425,11,42,.262,26,45,.578,.489,21,24,.875,8,38,46,20,17,11,11,46,106
200,Jared Harper\harpeja01,PG,23,NYK,5,0,10,0,3,.000,0,1,.000,0,2,.000,.000,2,2,1.000,0,0,0,0,0,0,2,0,2
201,Montrezl Harrell\harremo01,C,27,LAL,61,1,1456,346,554,.625,0,10,.000,346,544,.636,.625,160,224,.714,146,250,396,67,44,44,68,119,852
202,Gary Harris\harriga01,SG,26,TOT,29,28,861,107,263,.407,36,108,.333,71,155,.458,.475,56,69,.812,17,49,66,59,22,8,24,56,306
202,Gary Harris\harriga01,SG,26,DEN,19,19,581,69,156,.442,24,75,.320,45,81,.556,.519,22,30,.733,13,34,47,32,17,4,14,37,184
202,Gary Harris\harriga01,SG,26,ORL,10,9,280,38,107,.355,12,33,.364,26,74,.351,.411,34,39,.872,4,15,19,27,5,4,10,19,122
203,Jalen Harris\harrija01,SG,22,TOR,4,0,14,1,4,.250,1,2,.500,0,2,.000,.375,0,0,,1,2,3,2,1,0,1,2,3
204,Joe Harris\harrijo01,SF,29,BRK,62,58,1916,328,641,.512,195,405,.481,133,236,.564,.664,46,59,.780,40,181,221,119,42,13,51,125,897
205,Tobias Harris\harrito02,PF,28,PHI,53,53,1738,412,795,.518,73,180,.406,339,615,.551,.564,161,181,.890,52,323,375,195,50,46,98,107,1058
206,Shaquille Harrison\harrish01,SG,27,TOT,24,0,152,16,41,.390,0,4,.000,16,37,.432,.390,9,10,.900,5,14,19,12,10,0,8,12,41
206,Shaquille Harrison\harrish01,SG,27,UTA,17,0,56,6,20,.300,0,2,.000,6,18,.333,.300,5,6,.833,3,6,9,9,2,0,5,3,17
206,Shaquille Harrison\harrish01,SG,27,DEN,7,0,96,10,21,.476,0,2,.000,10,19,.526,.476,4,4,1.000,2,8,10,3,8,0,3,9,24
207,Josh Hart\hartjo01,SF,25,NOP,47,4,1349,151,344,.439,63,193,.326,88,151,.583,.531,69,89,.775,53,324,377,109,38,12,49,111,434
208,Isaiah Hartenstein\harteis01,C,22,TOT,44,2,533,90,158,.570,2,5,.400,88,153,.575,.576,44,69,.638,63,114,177,49,18,38,42,99,226
208,Isaiah Hartenstein\harteis01,C,22,DEN,30,0,272,41,80,.513,0,0,,41,80,.513,.513,22,36,.611,40,45,85,15,11,20,21,59,104
208,Isaiah Hartenstein\harteis01,C,22,CLE,14,2,261,49,78,.628,2,5,.400,47,73,.644,.641,22,33,.667,23,69,92,34,7,18,21,40,122
209,Jaxson Hayes\hayesja02,C,20,NOP,50,3,741,124,190,.653,3,7,.429,121,183,.661,.661,66,85,.776,64,128,192,26,19,24,31,87,317
210,Killian Hayes\hayeski01,PG,19,DET,17,10,388,40,118,.339,9,37,.243,31,81,.383,.377,8,9,.889,5,33,38,75,18,6,47,34,97
211,Gordon Hayward\haywago01,SF,30,CHO,44,44,1496,311,658,.473,85,205,.415,226,453,.499,.537,156,185,.843,37,221,258,181,52,14,91,74,863
212,Juan Hernangómez\hernaju01,PF,25,MIN,44,6,747,112,245,.457,44,134,.328,68,111,.613,.547,54,84,.643,36,138,174,28,16,6,21,42,322
213,Willy Hernangómez\hernawi01,C,26,NOP,38,3,616,107,191,.560,1,9,.111,106,182,.582,.563,39,60,.650,87,153,240,33,14,18,21,45,254
214,Tyler Herro\herroty01,SG,21,MIA,48,14,1472,268,627,.427,90,262,.344,178,365,.488,.499,89,110,.809,23,210,233,162,34,17,91,61,715
215,Buddy Hield\hieldbu01,SG,28,SAC,61,61,2088,349,852,.410,245,624,.393,104,228,.456,.553,78,92,.848,23,254,277,196,52,26,105,156,1021
216,George Hill\hillge01,PG,34,TOT,20,16,484,75,149,.503,25,65,.385,50,84,.595,.587,24,31,.774,11,33,44,54,15,5,20,18,199
216,George Hill\hillge01,PG,34,OKC,14,14,369,61,120,.508,22,57,.386,39,63,.619,.600,21,25,.840,8,21,29,43,12,2,12,12,165
216,George Hill\hillge01,PG,34,PHI,6,2,115,14,29,.483,3,8,.375,11,21,.524,.534,3,6,.500,3,12,15,11,3,3,8,6,34
217,Solomon Hill\hillso01,PF,29,ATL,62,13,1343,101,279,.362,64,197,.325,37,82,.451,.477,29,38,.763,38,147,185,64,46,10,36,106,295
218,Nate Hinton\hintona01,SG,21,DAL,15,0,57,9,23,.391,1,8,.125,8,15,.533,.413,4,6,.667,1,5,6,5,5,1,5,3,23
219,Jaylen Hoard\hoardja01,SF,21,OKC,11,0,181,22,49,.449,0,6,.000,22,43,.512,.449,18,25,.720,15,23,38,9,7,2,14,16,62
220,Aaron Holiday\holidaa01,PG,24,IND,59,6,1004,147,384,.383,60,163,.368,87,221,.394,.461,55,68,.809,10,60,70,96,38,10,53,86,409
221,Jrue Holiday\holidjr01,PG,30,MIL,49,46,1568,333,661,.504,89,226,.394,244,435,.561,.571,81,100,.810,60,165,225,280,86,24,104,82,836
222,Justin Holiday\holidju01,SG,31,IND,61,48,1874,217,536,.405,146,390,.374,71,146,.486,.541,54,69,.783,29,194,223,100,73,27,49,117,634
223,Rondae Hollis-Jefferson\holliro01,PF,26,POR,7,1,81,6,14,.429,0,1,.000,6,13,.462,.429,9,14,.643,10,9,19,10,2,4,2,12,21
224,Richaun Holmes\holmeri01,C,27,SAC,53,53,1569,319,496,.643,2,10,.200,317,486,.652,.645,119,150,.793,133,327,460,83,34,85,64,188,759
225,Rodney Hood\hoodro01,SF,28,TOT,50,5,890,90,249,.361,33,108,.306,57,141,.404,.428,19,23,.826,21,72,93,52,21,7,35,70,232
225,Rodney Hood\hoodro01,SF,28,POR,38,5,726,73,201,.363,25,84,.298,48,117,.410,.425,9,12,.750,18,55,73,47,20,4,31,59,180
225,Rodney Hood\hoodro01,SF,28,TOR,12,0,164,17,48,.354,8,24,.333,9,24,.375,.438,10,11,.909,3,17,20,5,1,3,4,11,52
226,Al Horford\horfoal01,C,34,OKC,28,28,782,162,360,.450,56,152,.368,106,208,.510,.528,18,22,.818,29,159,188,94,25,26,29,48,398
227,Talen Horton-Tucker\hortota01,SG,20,LAL,57,3,1121,191,428,.446,31,119,.261,160,309,.518,.482,82,103,.796,21,133,154,143,56,20,82,109,495
228,Danuel House\houseda01,SF,27,HOU,33,22,885,102,251,.406,51,144,.354,51,107,.477,.508,39,59,.661,18,106,124,61,19,16,31,63,294
229,Dwight Howard\howardw01,C,35,PHI,60,5,1038,147,251,.586,4,18,.222,143,233,.614,.594,104,182,.571,159,340,499,51,27,53,101,176,402
230,Markus Howard\howarma02,SG,21,DEN,30,0,98,13,50,.260,6,35,.171,7,15,.467,.320,1,2,.500,0,12,12,12,2,0,8,14,33
231,Kevin Huerter\huertke01,SG,22,ATL,62,47,1941,293,666,.440,129,352,.366,164,314,.522,.537,49,62,.790,35,170,205,219,77,15,74,150,764
232,Elijah Hughes\hugheel01,SF,22,UTA,14,0,50,8,23,.348,6,18,.333,2,5,.400,.478,3,4,.750,0,7,7,5,1,1,6,1,25
233,De'Andre Hunter\huntede01,SF,23,ATL,20,18,625,112,223,.502,31,87,.356,81,136,.596,.572,65,75,.867,16,86,102,42,18,10,27,53,320
234,Chandler Hutchison\hutchch01,SF,24,TOT,15,0,204,23,62,.371,4,14,.286,19,48,.396,.403,11,13,.846,4,49,53,9,4,1,15,22,61
234,Chandler Hutchison\hutchch01,SF,24,CHI,7,0,64,5,18,.278,1,3,.333,4,15,.267,.306,2,2,1.000,1,19,20,4,1,0,5,9,13
234,Chandler Hutchison\hutchch01,SF,24,WAS,8,0,140,18,44,.409,3,11,.273,15,33,.455,.443,9,11,.818,3,30,33,5,3,1,10,13,48
235,Serge Ibaka\ibakase01,C,31,LAC,39,39,919,176,347,.507,38,108,.352,138,239,.577,.562,37,45,.822,68,193,261,68,9,46,44,74,427
236,Andre Iguodala\iguodan01,SF,37,MIA,55,4,1183,86,227,.379,56,171,.327,30,56,.536,.502,22,34,.647,34,166,200,121,54,31,55,78,250
237,Ersan İlyasova\ilyaser01,PF,33,UTA,12,1,112,17,38,.447,14,30,.467,3,8,.375,.632,3,3,1.000,4,18,22,3,10,2,5,21,51
238,Joe Ingles\inglejo01,SF,33,UTA,57,20,1562,236,464,.509,162,339,.478,74,125,.592,.683,63,74,.851,24,185,209,252,38,12,94,103,697
239,Brandon Ingram\ingrabr01,SF,23,NOP,57,57,1961,489,1038,.471,136,354,.384,353,684,.516,.537,266,300,.887,32,253,285,278,38,36,146,116,1380
240,Kyrie Irving\irvinky01,PG,28,BRK,46,46,1620,467,929,.503,122,315,.387,345,614,.562,.568,181,196,.923,49,180,229,295,61,28,116,120,1237
241,Wesley Iwundu\iwundwe01,SF,26,TOT,36,4,477,31,88,.352,5,39,.128,26,49,.531,.381,24,29,.828,11,67,78,15,14,4,17,46,91
241,Wesley Iwundu\iwundwe01,SF,26,DAL,23,3,288,17,52,.327,3,23,.130,14,29,.483,.356,12,14,.857,6,38,44,10,9,3,6,26,49
241,Wesley Iwundu\iwundwe01,SF,26,NOP,13,1,189,14,36,.389,2,16,.125,12,20,.600,.417,12,15,.800,5,29,34,5,5,1,11,20,42
242,Frank Jackson\jacksfr01,PG,22,DET,33,4,554,99,213,.465,48,116,.414,51,97,.526,.577,42,53,.792,12,54,66,23,8,1,28,41,288
243,Jaren Jackson Jr.\jacksja02,C,21,MEM,4,0,88,21,50,.420,4,21,.190,17,29,.586,.460,15,20,.750,5,18,23,5,1,7,3,19,61
244,Josh Jackson\jacksjo02,SG,23,DET,56,21,1402,277,648,.427,70,230,.304,207,418,.495,.481,141,193,.731,51,175,226,122,48,41,124,160,765
245,Justin Jackson\jacksju01,SF,25,OKC,33,3,544,86,212,.406,34,111,.306,52,101,.515,.486,30,35,.857,14,57,71,51,15,2,31,31,236
246,Reggie Jackson\jacksre01,SG,30,LAC,60,38,1371,232,516,.450,103,235,.438,129,281,.459,.549,62,77,.805,23,149,172,192,35,6,68,121,629
247,Justin James\jamesju01,SF,24,SAC,27,0,168,24,50,.480,6,19,.316,18,31,.581,.540,8,16,.500,3,8,11,15,3,1,6,10,62
248,LeBron James\jamesle01,PG,36,LAL,41,41,1388,388,756,.513,98,266,.368,290,490,.592,.578,168,239,.703,24,299,323,323,43,24,152,65,1042
249,Mike James\jamesmi02,PG,30,BRK,3,0,49,7,14,.500,2,3,.667,5,11,.455,.571,5,8,.625,2,4,6,11,1,0,1,0,21
250,DaQuan Jeffries\jeffrda01,SG,23,TOT,24,2,312,29,75,.387,11,39,.282,18,36,.500,.460,6,7,.857,13,29,42,9,8,7,8,28,75
250,DaQuan Jeffries\jeffrda01,SG,23,SAC,18,2,232,24,57,.421,9,28,.321,15,29,.517,.500,6,7,.857,9,20,29,6,7,4,8,23,63
250,DaQuan Jeffries\jeffrda01,SG,23,HOU,6,0,80,5,18,.278,2,11,.182,3,7,.429,.333,0,0,,4,9,13,3,1,3,0,5,12
251,Ty Jerome\jeromty01,SG,23,OKC,29,1,704,110,251,.438,62,152,.408,48,99,.485,.562,20,28,.714,10,72,82,104,18,4,43,52,302
252,Isaiah Joe\joeis01,SG,21,PHI,34,1,309,35,106,.330,28,83,.337,7,23,.304,.462,12,16,.750,6,24,30,18,9,4,8,27,110
253,Alize Johnson\johnsal02,PF,24,BRK,12,0,127,30,49,.612,1,5,.200,29,44,.659,.622,3,3,1.000,18,37,55,9,4,2,8,9,64
254,Cameron Johnson\johnsca02,PF,24,PHO,56,11,1341,194,448,.433,113,311,.363,81,137,.591,.559,45,52,.865,30,154,184,82,32,16,38,80,546
255,James Johnson\johnsja01,PF,33,TOT,41,6,811,108,244,.443,25,97,.258,83,147,.565,.494,34,53,.642,22,111,133,81,34,38,45,94,275
255,James Johnson\johnsja01,PF,33,DAL,29,1,504,67,145,.462,15,60,.250,52,85,.612,.514,17,29,.586,14,72,86,50,24,23,27,59,166
255,James Johnson\johnsja01,PF,33,NOP,12,5,307,41,99,.414,10,37,.270,31,62,.500,.465,17,24,.708,8,39,47,31,10,15,18,35,109
256,Keldon Johnson\johnske04,SF,21,SAS,58,56,1666,288,594,.485,52,154,.338,236,440,.536,.529,119,164,.726,83,286,369,100,33,24,63,122,747
257,Stanley Johnson\johnsst04,PF,24,TOR,52,6,748,59,151,.391,31,89,.348,28,62,.452,.493,24,29,.828,22,97,119,63,39,16,41,90,173
258,Tyler Johnson\johnsty01,SG,28,BRK,33,2,565,62,153,.405,42,110,.382,20,43,.465,.542,18,21,.857,5,58,63,34,12,0,14,34,184
259,Nikola Jokić\jokicni01,C,25,DEN,62,62,2181,637,1122,.568,85,207,.411,552,915,.603,.606,271,317,.855,176,499,675,537,88,42,199,163,1630
260,Damian Jones\jonesda03,C,25,TOT,29,8,320,34,48,.708,0,1,.000,34,47,.723,.708,27,37,.730,23,44,67,11,5,15,17,53,95
260,Damian Jones\jonesda03,C,25,PHO,14,0,94,8,16,.500,0,1,.000,8,15,.533,.500,6,11,.545,7,11,18,4,1,5,6,19,22
260,Damian Jones\jonesda03,C,25,LAL,8,6,112,16,17,.941,0,0,,16,17,.941,.941,11,12,.917,8,18,26,1,1,7,5,22,43
260,Damian Jones\jonesda03,C,25,SAC,7,2,114,10,15,.667,0,0,,10,15,.667,.667,10,14,.714,8,15,23,6,3,3,6,12,30
261,Derrick Jones Jr.\jonesde02,SF,23,POR,54,42,1263,140,293,.478,43,133,.323,97,160,.606,.551,55,86,.640,76,125,201,43,36,53,29,118,378
262,Mason Jones\jonesma05,SG,22,TOT,32,1,334,52,123,.423,24,66,.364,28,57,.491,.520,40,64,.625,7,48,55,42,7,1,29,24,168
262,Mason Jones\jonesma05,SG,22,HOU,26,1,307,47,114,.412,23,64,.359,24,50,.480,.513,35,57,.614,4,47,51,39,6,1,28,22,152
262,Mason Jones\jonesma05,SG,22,PHI,6,0,27,5,9,.556,1,2,.500,4,7,.571,.611,5,7,.714,3,1,4,3,1,0,1,2,16
263,Tre Jones\jonestr01,PG,21,SAS,29,0,156,22,48,.458,2,3,.667,20,45,.444,.479,9,9,1.000,5,8,13,19,6,0,12,8,55
264,Tyus Jones\jonesty01,PG,24,MEM,59,8,1075,162,370,.438,39,126,.310,123,244,.504,.491,33,36,.917,20,102,122,228,59,5,42,27,396
265,DeAndre Jordan\jordade01,C,32,BRK,53,41,1182,183,235,.779,0,1,.000,183,234,.782,.779,40,79,.506,107,291,398,89,16,64,80,109,406
266,Cory Joseph\josepco01,PG,29,TOT,60,10,1361,184,392,.469,43,125,.344,141,267,.528,.524,69,85,.812,33,115,148,194,58,16,72,131,480
266,Cory Joseph\josepco01,PG,29,SAC,44,2,944,111,250,.444,31,94,.330,80,156,.513,.506,36,47,.766,25,74,99,108,39,9,44,98,289
266,Cory Joseph\josepco01,PG,29,DET,16,8,417,73,142,.514,12,31,.387,61,111,.550,.556,33,38,.868,8,41,49,86,19,7,28,33,191
267,Mfiondu Kabengele\kabenmf01,PF,23,TOT,29,0,138,15,44,.341,7,26,.269,8,18,.444,.420,7,8,.875,2,20,22,9,4,4,7,24,44
267,Mfiondu Kabengele\kabenmf01,PF,23,LAC,23,0,94,9,32,.281,4,18,.222,5,14,.357,.344,5,6,.833,1,13,14,5,2,3,6,18,27
267,Mfiondu Kabengele\kabenmf01,PF,23,CLE,6,0,44,6,12,.500,3,8,.375,3,4,.750,.625,2,2,1.000,1,7,8,4,2,1,1,6,17
268,Frank Kaminsky\kaminfr01,C,27,PHO,37,13,532,90,190,.474,28,70,.400,62,120,.517,.547,26,43,.605,24,107,131,56,13,14,17,46,234
269,Enes Kanter\kanteen01,C,28,POR,62,35,1577,308,507,.607,0,1,.000,308,506,.609,.607,114,146,.781,259,448,707,79,30,43,71,152,730
270,Luke Kennard\kennalu01,SG,24,LAC,57,15,1132,179,374,.479,93,202,.460,86,172,.500,.603,24,29,.828,14,140,154,97,20,9,45,85,475
271,Maxi Kleber\klebima01,PF,29,DAL,45,38,1224,104,246,.423,78,187,.417,26,59,.441,.581,32,35,.914,41,198,239,61,24,33,29,102,318
272,Nathan Knight\knighna01,PF,23,ATL,29,0,238,29,82,.354,5,27,.185,24,55,.436,.384,41,49,.837,23,36,59,6,8,7,15,21,104
273,Kevin Knox\knoxke01,SF,21,NYK,39,0,453,55,138,.399,34,87,.391,21,51,.412,.522,14,18,.778,10,51,61,18,11,6,16,37,158
274,John Konchar\konchjo01,SG,24,MEM,36,0,476,48,105,.457,15,41,.366,33,64,.516,.529,20,24,.833,25,75,100,38,30,7,17,35,131
275,Furkan Korkmaz\korkmfu01,SG,23,PHI,49,10,965,158,383,.413,94,242,.388,64,141,.454,.535,58,79,.734,12,86,98,65,47,8,43,58,468
276,Luke Kornet\kornelu01,PF-C,25,TOT,25,0,245,30,72,.417,13,47,.277,17,25,.680,.507,3,6,.500,9,40,49,18,2,21,4,11,76
276,Luke Kornet\kornelu01,PF,25,CHI,13,0,94,9,27,.333,6,23,.261,3,4,.750,.444,2,4,.500,1,14,15,4,2,7,1,1,26
276,Luke Kornet\kornelu01,C,25,BOS,12,0,151,21,45,.467,7,24,.292,14,21,.667,.544,1,2,.500,8,26,34,14,0,14,3,10,50
277,Rodions Kurucs\kurucro01,SF-PF,22,TOT,21,0,125,11,32,.344,6,21,.286,5,11,.455,.438,3,4,.750,5,18,23,10,9,4,13,16,31
277,Rodions Kurucs\kurucro01,PF,22,BRK,5,0,16,1,3,.333,1,2,.500,0,1,.000,.500,0,0,,0,3,3,2,0,0,0,1,3
277,Rodions Kurucs\kurucro01,SF,22,HOU,11,0,75,5,21,.238,2,15,.133,3,6,.500,.286,1,2,.500,2,9,11,4,6,4,9,7,13
277,Rodions Kurucs\kurucro01,SF,22,MIL,5,0,34,5,8,.625,3,4,.750,2,4,.500,.813,2,2,1.000,3,6,9,4,3,0,4,8,15
278,Kyle Kuzma\kuzmaky01,SF,25,LAL,59,29,1688,291,668,.436,120,336,.357,171,332,.515,.525,55,81,.679,104,274,378,107,30,34,100,104,757
279,Anthony Lamb\lamban01,SF,23,HOU,14,0,167,18,55,.327,9,33,.273,9,22,.409,.409,6,7,.857,15,17,32,6,1,2,6,18,51
280,Jeremy Lamb\lambje01,SG,28,IND,36,8,765,120,276,.435,52,128,.406,68,148,.459,.529,71,75,.947,25,106,131,53,34,23,22,72,363
281,Romeo Langford\langfro01,SG,21,BOS,13,3,202,12,39,.308,4,15,.267,8,24,.333,.359,4,4,1.000,11,18,29,8,4,4,8,15,32
282,Zach LaVine\lavinza01,SG,25,CHI,53,53,1867,521,1030,.506,182,437,.416,339,593,.572,.594,234,276,.848,32,238,270,269,43,27,193,124,1458
283,Jake Layman\laymaja01,SF,26,MIN,42,11,602,87,175,.497,21,73,.288,66,102,.647,.557,26,37,.703,13,51,64,28,29,17,26,41,221
284,T.J. Leaf\leaftj01,PF,23,POR,1,0,9,1,1,1.000,0,0,,1,1,1.000,1.000,0,0,,0,0,0,0,1,0,1,0,2
285,Jalen Lecque\lecquja01,PG,20,IND,4,0,12,1,9,.111,0,1,.000,1,8,.125,.111,3,3,1.000,2,3,5,2,0,0,0,0,5
286,Damion Lee\leeda03,SG,28,GSW,57,1,1079,128,274,.467,77,194,.397,51,80,.638,.608,40,44,.909,22,158,180,73,38,8,30,89,373
287,Saben Lee\leesa01,PG,21,DET,38,7,575,71,153,.464,7,16,.438,64,137,.467,.487,50,74,.676,16,62,78,124,26,10,40,59,199
288,Alex Len\lenal01,C,27,TOT,54,32,842,152,240,.633,8,25,.320,144,215,.670,.650,63,105,.600,63,152,215,44,14,56,53,111,375
288,Alex Len\lenal01,C,27,TOR,7,2,76,5,10,.500,3,6,.500,2,4,.500,.650,3,6,.500,0,11,11,3,1,6,8,10,16
288,Alex Len\lenal01,C,27,WAS,47,30,766,147,230,.639,5,19,.263,142,211,.673,.650,60,99,.606,63,141,204,41,13,50,45,101,359
289,Kawhi Leonard\leonaka01,SF,29,LAC,46,46,1581,431,836,.516,90,229,.393,341,607,.562,.569,231,263,.878,52,255,307,235,77,20,91,76,1183
290,Meyers Leonard\leoname01,C,28,MIA,3,2,29,3,7,.429,3,7,.429,0,0,,.643,1,2,.500,0,7,7,2,0,0,2,5,10
291,Caris LeVert\leverca01,SG,26,TOT,37,29,1136,265,609,.435,59,199,.296,206,410,.502,.484,100,128,.781,29,137,166,173,53,21,70,75,689
291,Caris LeVert\leverca01,SG,26,BRK,12,4,334,87,200,.435,22,63,.349,65,137,.474,.490,26,34,.765,10,42,52,72,13,6,26,20,222
291,Caris LeVert\leverca01,SG,26,IND,25,25,802,178,409,.435,37,136,.272,141,273,.516,.480,74,94,.787,19,95,114,101,40,15,44,55,467
292,Kira Lewis Jr.\lewiski01,PG,19,NOP,44,0,724,109,276,.395,36,101,.356,73,175,.417,.460,26,33,.788,9,44,53,102,32,10,28,68,280
293,Damian Lillard\lillada01,PG,30,POR,57,57,2041,497,1147,.433,227,608,.373,270,539,.501,.532,389,420,.926,28,210,238,424,53,15,178,92,1610
294,Nassir Little\littlna01,PF,20,POR,42,2,588,69,154,.448,27,78,.346,42,76,.553,.536,35,44,.795,30,88,118,21,5,13,16,50,200
295,Kevon Looney\looneke01,C,24,GSW,51,24,896,85,160,.531,4,17,.235,81,143,.566,.544,24,34,.706,99,147,246,96,20,18,32,106,198
296,Brook Lopez\lopezbr01,C,32,MIL,60,60,1630,261,535,.488,91,261,.349,170,274,.620,.573,94,110,.855,83,212,295,44,37,84,52,124,707
297,Robin Lopez\lopezro01,C,32,WAS,61,9,1186,223,352,.634,5,18,.278,218,334,.653,.641,85,120,.708,120,116,236,51,14,37,65,96,536
298,Kevin Love\loveke01,PF,32,CLE,19,19,451,73,189,.386,38,119,.319,35,70,.500,.487,33,41,.805,12,114,126,47,12,2,26,19,217
299,Kyle Lowry\lowryky01,PG,34,TOR,44,44,1527,241,560,.430,118,308,.383,123,252,.488,.536,134,152,.882,34,206,240,320,43,13,124,135,734
300,Timothé Luwawu-Cabarrot\luwawti01,SF,25,BRK,53,7,1009,123,341,.361,72,229,.314,51,112,.455,.466,32,40,.800,26,100,126,63,32,6,41,96,350
301,Trey Lyles\lylestr01,PF,25,SAS,23,9,358,43,90,.478,14,40,.350,29,50,.580,.556,15,23,.652,9,77,86,14,6,1,6,13,115
302,Will Magnay\magnawi01,C,22,NOP,1,0,3,0,1,.000,0,1,.000,0,0,,.000,0,0,,0,0,0,0,0,0,1,1,0
303,Thon Maker\makerth01,C,23,CLE,8,0,76,10,18,.556,0,2,.000,10,16,.625,.556,10,11,.909,8,10,18,4,2,4,3,7,30
304,Théo Maledon\maledth01,PG,19,OKC,56,40,1541,190,510,.373,90,258,.349,100,252,.397,.461,81,109,.743,22,169,191,197,51,7,125,115,551
305,Karim Mané\maneka01,PG,20,ORL,10,0,88,3,13,.231,1,2,.500,2,11,.182,.269,4,5,.800,1,13,14,4,0,2,3,10,11
306,Terance Mann\mannte01,SG,24,LAC,61,10,1192,158,324,.488,35,85,.412,123,239,.515,.542,68,83,.819,53,177,230,100,28,13,39,120,419
307,Nico Mannion\mannini01,PG,19,GSW,25,1,308,34,99,.343,19,52,.365,15,47,.319,.439,20,25,.800,3,33,36,58,14,1,26,26,107
308,Boban Marjanović\marjabo01,C,32,DAL,26,3,229,54,107,.505,0,6,.000,54,101,.535,.505,22,28,.786,40,68,108,7,1,5,10,27,130
309,Lauri Markkanen\markkla01,PF,23,CHI,42,25,1120,217,452,.480,99,252,.393,118,200,.590,.590,68,81,.840,29,192,221,38,19,12,43,62,601
310,Naji Marshall\marshna01,SF,23,NOP,22,4,426,39,107,.364,16,47,.340,23,60,.383,.439,37,56,.661,6,76,82,57,16,7,19,38,131
311,Caleb Martin\martica02,SF,25,CHO,46,2,685,83,219,.379,26,103,.252,57,116,.491,.438,33,53,.623,29,97,126,55,32,9,29,52,225
312,Cody Martin\martico01,SF,25,CHO,50,8,818,83,184,.451,16,56,.286,67,128,.523,.495,25,41,.610,51,105,156,82,33,11,39,48,207
313,Jeremiah Martin\martije02,G,24,CLE,1,0,4,0,1,.000,0,0,,0,1,.000,.000,0,0,,0,0,0,0,0,0,1,0,0
314,Kelan Martin\martike03,SF,25,IND,24,0,136,22,53,.415,8,23,.348,14,30,.467,.491,6,7,.857,10,21,31,8,5,3,7,14,58
315,Kenyon Martin Jr.\martike04,SF,20,HOU,35,1,713,97,191,.508,14,44,.318,83,147,.565,.545,43,60,.717,58,103,161,22,22,32,23,60,251
316,Frank Mason III\masonfr01,PG,26,ORL,4,1,79,9,24,.375,2,5,.400,7,19,.368,.417,5,7,.714,3,9,12,12,0,0,5,7,25
317,Garrison Mathews\mathega01,SG,24,WAS,56,22,946,88,214,.411,68,177,.384,20,37,.541,.570,70,78,.897,16,64,80,25,28,6,9,96,314
318,Dakota Mathias\mathida01,SG,25,PHI,8,2,123,19,48,.396,8,26,.308,11,22,.500,.479,2,6,.333,1,6,7,13,1,3,1,7,48
319,Wesley Matthews\matthwe02,SG,34,LAL,50,7,965,71,212,.335,54,168,.321,17,44,.386,.462,30,35,.857,14,63,77,46,32,15,22,70,226
320,Tyrese Maxey\maxeyty01,SG,20,PHI,53,6,778,166,360,.461,24,87,.276,142,273,.520,.494,43,50,.860,9,72,81,89,19,9,34,65,399
321,Skylar Mays\mayssk01,SG,23,ATL,29,0,229,33,81,.407,11,33,.333,22,48,.458,.475,22,25,.880,10,21,31,22,14,0,8,14,99
322,Patrick McCaw\mccawpa01,SF,25,TOR,5,0,33,1,1,1.000,0,0,,1,1,1.000,1.000,3,3,1.000,1,2,3,4,2,0,0,6,5
323,CJ McCollum\mccolcj01,SG,29,POR,37,37,1250,321,705,.455,137,347,.395,184,358,.514,.552,82,100,.820,25,127,152,177,39,17,52,73,861
324,T.J. McConnell\mccontj01,PG,28,IND,58,2,1485,217,388,.559,13,37,.351,204,351,.581,.576,25,38,.658,42,165,207,383,101,20,107,93,472
325,Jaden McDaniels\mcdanja02,PF,20,MIN,56,22,1320,146,329,.444,63,172,.366,83,157,.529,.540,24,41,.585,46,162,208,60,30,54,41,147,379
326,Jalen McDaniels\mcdanja01,SF,23,CHO,37,10,622,92,201,.458,24,73,.329,68,128,.531,.517,32,45,.711,24,78,102,37,22,11,34,70,240
327,Doug McDermott\mcderdo01,PF,29,IND,55,19,1321,283,538,.526,87,231,.377,196,307,.638,.607,65,80,.813,55,141,196,71,17,4,44,92,718
328,Sean McDermott\mcderse01,SF,24,MEM,17,0,156,13,33,.394,5,22,.227,8,11,.727,.470,8,8,1.000,6,13,19,4,2,3,4,8,39
329,JaVale McGee\mcgeeja01,C,33,TOT,39,1,569,123,238,.517,5,21,.238,118,217,.544,.527,40,61,.656,62,133,195,34,18,45,53,97,291
329,JaVale McGee\mcgeeja01,C,33,CLE,33,1,503,112,215,.521,5,20,.250,107,195,.549,.533,36,55,.655,54,116,170,33,16,40,45,80,265
329,JaVale McGee\mcgeeja01,C,33,DEN,6,0,66,11,23,.478,0,1,.000,11,22,.500,.478,4,6,.667,8,17,25,1,2,5,8,17,26
330,Rodney McGruder\mcgruro01,SG,29,DET,16,2,194,37,70,.529,11,24,.458,26,46,.565,.607,6,8,.750,8,14,22,16,8,1,7,12,91
331,Alfonzo McKinnie\mckinal01,SF,28,LAL,35,0,222,39,75,.520,14,32,.438,25,43,.581,.613,9,17,.529,17,29,46,6,5,0,4,21,101
332,Jordan McLaughlin\mclaujo01,PG,24,MIN,43,2,817,84,210,.400,27,75,.360,57,135,.422,.464,18,24,.750,18,72,90,176,47,6,43,37,213
333,Ben McLemore\mclembe01,SG,27,TOT,43,5,733,114,306,.373,79,230,.343,35,76,.461,.502,39,53,.736,15,71,86,34,22,6,36,79,346
333,Ben McLemore\mclembe01,SG,27,HOU,32,4,537,80,224,.357,55,166,.331,25,58,.431,.480,23,32,.719,11,55,66,28,20,3,28,51,238
333,Ben McLemore\mclembe01,SG,27,LAL,11,1,196,34,82,.415,24,64,.375,10,18,.556,.561,16,21,.762,4,16,20,6,2,3,8,28,108
334,Nicolò Melli\mellini01,PF,30,TOT,36,4,447,34,105,.324,15,62,.242,19,43,.442,.395,12,15,.800,22,75,97,35,13,3,10,50,95
334,Nicolò Melli\mellini01,PF,30,NOP,22,0,241,15,59,.254,7,37,.189,8,22,.364,.314,6,7,.857,12,45,57,25,9,1,7,28,43
334,Nicolò Melli\mellini01,PF,30,DAL,14,4,206,19,46,.413,8,25,.320,11,21,.524,.500,6,8,.750,10,30,40,10,4,2,3,22,52
335,De'Anthony Melton\meltode01,PG,22,MEM,41,1,844,150,324,.463,74,167,.443,76,157,.484,.577,35,45,.778,26,106,132,111,51,20,50,72,409
336,Sam Merrill\merrisa01,SG,24,MIL,27,1,199,30,62,.484,20,41,.488,10,21,.476,.645,4,4,1.000,6,21,27,20,5,1,10,15,84
337,Chimezie Metu\metuch01,C,23,SAC,29,1,318,63,117,.538,4,14,.286,59,103,.573,.556,20,29,.690,25,51,76,21,11,15,20,46,150
338,Khris Middleton\middlkh01,SF,29,MIL,59,59,1966,438,916,.478,130,306,.425,308,610,.505,.549,175,198,.884,49,300,349,320,67,9,159,139,1181
339,Darius Miller\milleda01,SF,30,OKC,18,0,197,22,48,.458,17,42,.405,5,6,.833,.635,12,12,1.000,2,22,24,21,13,5,8,13,73
340,Patty Mills\millspa02,PG,32,SAS,58,0,1470,227,541,.420,144,378,.381,83,163,.509,.553,63,69,.913,17,83,100,142,37,2,55,70,661
341,Paul Millsap\millspa01,PF,35,DEN,49,34,1030,165,341,.484,45,128,.352,120,213,.563,.550,61,86,.709,65,171,236,82,42,34,43,98,436
342,Shake Milton\miltosh01,SG,24,PHI,54,3,1276,262,586,.447,60,174,.345,202,412,.490,.498,132,158,.835,31,96,127,162,35,14,94,116,716
343,Donovan Mitchell\mitchdo01,PG,24,UTA,53,53,1771,478,1091,.438,178,461,.386,300,630,.476,.520,267,316,.845,50,185,235,277,52,15,147,117,1401
344,Adam Mokoka\mokokad01,SG,22,CHI,12,0,53,7,18,.389,1,10,.100,6,8,.750,.417,0,1,.000,1,4,5,5,2,1,3,5,15
345,Malik Monk\monkma01,SG,22,CHO,32,0,694,148,322,.460,70,165,.424,78,157,.497,.568,53,65,.815,12,73,85,61,16,4,47,39,419
346,E'Twaun Moore\mooreet01,SG,31,PHO,24,1,348,43,102,.422,8,29,.276,35,73,.479,.461,8,10,.800,13,29,42,35,14,4,18,31,102
347,Ja Morant\moranja01,PG,21,MEM,53,53,1700,369,806,.458,58,194,.299,311,612,.508,.494,237,322,.736,48,157,205,388,48,10,164,76,1033
348,Juwan Morgan\morgaju01,PF,23,UTA,24,0,120,11,23,.478,3,12,.250,8,11,.727,.543,3,7,.429,8,17,25,9,4,1,3,20,28
349,Marcus Morris\morrima03,PF,31,LAC,50,22,1325,248,530,.468,128,272,.471,120,258,.465,.589,58,72,.806,31,178,209,51,32,13,45,106,682
350,Markieff Morris\morrima02,PF,31,LAL,54,26,1103,144,347,.415,62,198,.313,82,149,.550,.504,32,43,.744,45,200,245,62,19,18,50,96,382
351,Monte Morris\morrimo01,PG,25,DEN,44,13,1151,174,365,.477,49,130,.377,125,235,.532,.544,56,71,.789,11,84,95,141,31,13,32,45,453
352,Mychal Mulder\muldemy01,PG,26,GSW,50,5,539,77,174,.443,55,143,.385,22,31,.710,.601,11,19,.579,3,39,42,18,9,9,10,38,220
353,Dejounte Murray\murrade01,PG,24,SAS,58,58,1850,379,840,.451,59,179,.330,320,661,.484,.486,95,118,.805,49,365,414,310,92,6,99,121,912
354,Jamal Murray\murraja01,PG,23,DEN,48,48,1704,378,792,.477,129,316,.408,249,476,.523,.559,133,153,.869,37,157,194,231,64,13,108,95,1018
355,Mike Muscala\muscami01,C,29,OKC,35,0,645,119,267,.446,68,184,.370,51,83,.614,.573,33,36,.917,19,113,132,28,8,11,21,54,339
356,Sviatoslav Mykhailiuk\mykhasv01,SF-SG,23,TOT,58,14,1155,167,411,.406,88,264,.333,79,147,.537,.513,34,45,.756,23,124,147,96,43,11,78,52,456
356,Sviatoslav Mykhailiuk\mykhasv01,SF,23,DET,36,5,634,84,223,.377,57,171,.333,27,52,.519,.504,24,30,.800,11,63,74,57,27,6,39,33,249
356,Sviatoslav Mykhailiuk\mykhasv01,SG,23,OKC,22,9,521,83,188,.441,31,93,.333,52,95,.547,.524,10,15,.667,12,61,73,39,16,5,39,19,207
357,Abdel Nader\naderab01,SF,27,PHO,24,0,355,57,116,.491,18,43,.419,39,73,.534,.569,28,37,.757,7,55,62,19,10,9,19,34,160
358,Larry Nance Jr.\nancela02,PF,28,CLE,35,27,1091,128,272,.471,41,114,.360,87,158,.551,.546,30,49,.612,54,181,235,107,61,17,55,72,327
359,Aaron Nesmith\nesmiaa01,SF,21,BOS,37,0,484,47,121,.388,28,82,.341,19,39,.487,.504,14,20,.700,19,68,87,13,12,9,19,55,136
360,Raul Neto\netora01,PG,28,WAS,56,14,1184,177,386,.459,55,145,.379,122,241,.506,.530,54,63,.857,23,107,130,120,63,4,46,86,463
361,Georges Niang\niangge01,PF,27,UTA,62,2,923,139,318,.437,98,233,.421,41,85,.482,.591,13,13,1.000,25,128,153,49,18,7,43,97,389
362,Zeke Nnaji\nnajize01,PF,20,DEN,39,1,360,45,93,.484,20,53,.377,25,40,.625,.591,12,15,.800,13,45,58,8,6,4,7,27,122
363,Nerlens Noel\noelne01,C,26,NYK,56,33,1341,122,199,.613,0,3,.000,122,196,.622,.613,43,61,.705,128,236,364,45,60,123,60,151,287
364,Jaylen Nowell\nowelja01,SG,21,MIN,38,0,714,136,318,.428,47,139,.338,89,179,.497,.502,42,51,.824,18,71,89,59,21,10,27,68,361
365,Frank Ntilikina\ntilila01,PG,22,NYK,25,4,262,24,65,.369,18,38,.474,6,27,.222,.508,8,16,.500,5,20,25,15,15,2,10,38,74
366,Kendrick Nunn\nunnke01,PG,25,MIA,48,36,1400,261,555,.470,105,275,.382,156,280,.557,.565,48,52,.923,17,139,156,131,46,12,71,92,675
367,James Nunnally\nunnaja01,SF,30,NOP,4,0,25,4,8,.500,3,7,.429,1,1,1.000,.688,0,0,,1,3,4,0,0,0,1,0,11
368,Jusuf Nurkić\nurkiju01,C,26,POR,27,27,622,111,227,.489,9,25,.360,102,202,.505,.509,50,78,.641,59,167,226,89,26,26,55,76,281
369,David Nwaba\nwabada01,SF,28,HOU,30,9,679,106,218,.486,17,63,.270,89,155,.574,.525,47,68,.691,40,78,118,31,30,21,17,60,276
370,Jordan Nwora\nworajo01,SF,22,MIL,25,2,227,48,108,.444,24,52,.462,24,56,.429,.556,17,21,.810,4,40,44,7,14,5,20,19,137
371,Royce O'Neale\onealro01,SF,27,UTA,61,61,1943,149,338,.441,91,240,.379,58,98,.592,.575,36,42,.857,75,353,428,158,46,29,69,162,425
372,Semi Ojeleye\ojelese01,PF,26,BOS,51,13,884,81,204,.397,56,147,.381,25,57,.439,.534,24,32,.750,28,106,134,35,15,0,20,54,242
373,Jahlil Okafor\okafoja01,C,25,DET,19,0,210,37,62,.597,2,6,.333,35,56,.625,.613,8,10,.800,13,26,39,11,3,3,10,22,84
374,Chuma Okeke\okekech01,PF,22,ORL,45,19,1133,135,324,.417,49,141,.348,86,183,.470,.492,30,40,.750,42,139,181,101,48,23,38,48,349
375,Josh Okogie\okogijo01,SG,22,MIN,50,34,1054,91,227,.401,27,98,.276,64,129,.496,.460,71,89,.798,50,83,133,55,48,23,36,110,280
376,Onyeka Okongwu\okongon01,C,20,ATL,41,3,465,64,105,.610,0,2,.000,64,103,.621,.610,28,45,.622,42,78,120,10,18,26,22,82,156
377,Isaac Okoro\okorois01,SG,20,CLE,57,57,1815,179,424,.422,48,166,.289,131,258,.508,.479,81,110,.736,57,107,164,100,59,23,74,154,487
378,KZ Okpala\okpalkz01,PF,21,MIA,31,9,386,29,85,.341,12,48,.250,17,37,.459,.412,3,10,.300,18,42,60,15,8,8,13,53,73
379,Victor Oladipo\oladivi01,SG,28,TOT,33,33,1080,235,576,.408,78,239,.326,157,337,.466,.476,104,138,.754,12,148,160,151,46,14,83,81,652
379,Victor Oladipo\oladivi01,SG,28,IND,9,9,300,64,152,.421,25,69,.362,39,83,.470,.503,27,37,.730,1,50,51,38,15,2,18,23,180
379,Victor Oladipo\oladivi01,SG,28,HOU,20,20,669,155,381,.407,49,153,.320,106,228,.465,.471,65,83,.783,8,87,95,99,24,10,51,45,424
379,Victor Oladipo\oladivi01,SG,28,MIA,4,4,111,16,43,.372,4,17,.235,12,26,.462,.419,12,18,.667,3,11,14,14,7,2,14,13,48
380,Kelly Olynyk\olynyke01,C-PF,29,TOT,61,53,1715,284,582,.488,110,329,.334,174,253,.688,.582,87,104,.837,67,338,405,145,60,35,98,173,765
380,Kelly Olynyk\olynyke01,C,29,MIA,43,38,1157,162,376,.431,77,243,.317,85,133,.639,.533,31,40,.775,44,217,261,91,40,26,55,123,432
380,Kelly Olynyk\olynyke01,PF,29,HOU,18,15,558,122,206,.592,33,86,.384,89,120,.742,.672,56,64,.875,23,121,144,54,20,9,43,50,333
381,Miye Oni\onimi01,SG,23,UTA,45,0,409,30,86,.349,25,76,.329,5,10,.500,.494,5,6,.833,19,53,72,19,6,8,15,51,90
382,Cedi Osman\osmande01,SF,25,CLE,52,20,1287,182,498,.365,84,278,.302,98,220,.445,.450,63,82,.768,33,139,172,139,48,9,58,101,511
383,Daniel Oturu\oturuda01,C,21,LAC,25,0,103,15,28,.536,0,1,.000,15,27,.556,.536,5,8,.625,11,17,28,7,1,3,5,14,35
384,Kelly Oubre Jr.\oubreke01,SF,25,GSW,55,50,1687,318,724,.439,90,285,.316,228,439,.519,.501,123,177,.695,82,247,329,73,57,42,70,121,849
385,Jabari Parker\parkeja01,PF,25,TOT,9,0,103,18,33,.545,0,5,.000,18,28,.643,.545,3,4,.750,7,18,25,7,1,4,7,8,39
385,Jabari Parker\parkeja01,PF,25,SAC,3,0,27,4,7,.571,0,1,.000,4,6,.667,.571,0,0,,1,5,6,1,0,1,3,4,8
385,Jabari Parker\parkeja01,PF,25,BOS,6,0,76,14,26,.538,0,4,.000,14,22,.636,.538,3,4,.750,6,13,19,6,1,3,4,4,31
386,Eric Paschall\pascher01,PF,24,GSW,39,2,676,144,293,.491,17,53,.321,127,240,.529,.520,64,89,.719,27,97,124,51,12,7,41,65,369
387,Anžejs Pasečņiks\pasecan01,C,25,WAS,1,0,6,0,1,.000,0,1,.000,0,0,,.000,0,0,,1,0,1,1,0,0,5,2,0
388,Patrick Patterson\pattepa01,PF,31,LAC,35,4,503,63,143,.441,36,97,.371,27,46,.587,.566,12,16,.750,16,51,67,22,13,8,11,43,174
389,Justin Patton\pattoju01,C,23,HOU,13,6,247,29,70,.414,9,34,.265,20,36,.556,.479,3,4,.750,14,35,49,14,12,14,4,34,70
390,Chris Paul\paulch01,PG,35,PHO,61,61,1938,377,765,.493,89,231,.385,288,534,.539,.551,148,159,.931,24,258,282,532,87,14,135,144,991
391,Cameron Payne\payneca01,PG,26,PHO,51,0,884,146,313,.466,54,132,.409,92,181,.508,.553,36,42,.857,15,103,118,182,30,12,53,84,382
392,Elfrid Payton\paytoel01,PG,26,NYK,54,54,1350,254,575,.442,27,93,.290,227,482,.471,.465,70,102,.686,63,130,193,186,41,9,92,98,605
393,Gary Payton II\paytoga02,PG,28,GSW,10,0,40,10,13,.769,2,4,.500,8,9,.889,.846,3,4,.750,2,9,11,1,6,1,1,8,25
394,Norvel Pelle\pelleno01,C,27,TOT,9,0,59,6,12,.500,0,0,,6,12,.500,.500,4,6,.667,5,10,15,1,1,6,3,10,16
394,Norvel Pelle\pelleno01,C,27,BRK,3,0,28,3,7,.429,0,0,,3,7,.429,.429,0,0,,3,4,7,0,0,3,3,9,6
394,Norvel Pelle\pelleno01,C,27,SAC,1,0,4,0,1,.000,0,0,,0,1,.000,.000,3,4,.750,1,0,1,1,0,0,0,1,3
394,Norvel Pelle\pelleno01,C,27,NYK,5,0,27,3,4,.750,0,0,,3,4,.750,.750,1,2,.500,1,6,7,0,1,3,0,0,7
395,Reggie Perry\perryre01,PF,20,BRK,21,0,199,31,74,.419,4,20,.200,27,54,.500,.446,10,13,.769,24,42,66,14,6,6,14,36,76
396,Theo Pinson\pinsoth01,SG,25,NYK,15,0,32,1,9,.111,0,8,.000,1,1,1.000,.111,0,0,,0,3,3,1,0,0,1,4,2
397,Mason Plumlee\plumlma01,C,30,DET,55,55,1474,228,372,.613,0,7,.000,228,365,.625,.613,113,169,.669,142,371,513,197,42,48,104,182,569
398,Jakob Poeltl\poeltja01,C,25,SAS,60,42,1581,227,361,.629,0,0,,227,361,.629,.629,54,110,.491,194,283,477,112,39,106,78,149,508
399,Vincent Poirier\poirivi01,C,27,PHI,10,0,39,3,12,.250,0,1,.000,3,11,.273,.250,2,6,.333,6,8,14,2,0,3,4,8,8
400,Aleksej Pokusevski\pokusal01,PF,19,OKC,39,22,921,112,340,.329,48,180,.267,64,160,.400,.400,25,32,.781,26,155,181,84,18,41,80,49,297
401,Jordan Poole\poolejo01,SG,21,GSW,41,6,759,152,364,.418,72,206,.350,80,158,.506,.516,71,80,.888,9,58,67,78,22,7,39,69,447
402,Jontay Porter\portejo01,PF,21,MEM,8,0,26,3,9,.333,2,7,.286,1,2,.500,.444,3,3,1.000,2,7,9,1,2,0,5,6,11
403,Kevin Porter Jr.\porteke02,SG,20,HOU,22,19,699,122,297,.411,37,129,.287,85,168,.506,.473,54,71,.761,16,68,84,136,18,7,77,53,335
404,Michael Porter Jr.\portemi01,SF,22,DEN,52,45,1630,371,682,.544,138,312,.442,233,370,.630,.645,91,118,.771,86,308,394,54,32,51,59,105,971
405,Otto Porter\porteot01,SF-PF,27,TOT,28,6,606,98,227,.432,39,104,.375,59,123,.480,.518,36,42,.857,28,124,152,55,16,4,25,41,271
405,Otto Porter\porteot01,SF,27,CHI,25,6,540,89,202,.441,38,95,.400,51,107,.477,.535,31,37,.838,28,110,138,50,12,4,25,37,247
405,Otto Porter\porteot01,PF,27,ORL,3,0,66,9,25,.360,1,9,.111,8,16,.500,.380,5,5,1.000,0,14,14,5,4,0,0,4,24
406,Bobby Portis\portibo01,C,25,MIL,57,6,1199,270,514,.525,67,140,.479,203,374,.543,.590,42,56,.750,101,295,396,63,41,22,49,99,649
407,Kristaps Porziņģis\porzikr01,C,25,DAL,39,39,1224,298,629,.474,87,240,.363,211,389,.542,.543,113,133,.850,77,284,361,64,19,57,51,106,796
408,Dwight Powell\poweldw01,C,29,DAL,47,13,701,86,150,.573,5,20,.250,81,130,.623,.590,67,88,.761,56,113,169,36,27,15,28,102,244
409,Norman Powell\powelno01,SG-SF,27,TOT,60,49,1883,385,799,.482,149,364,.409,236,435,.543,.575,204,236,.864,36,146,182,113,74,15,110,141,1123
409,Norman Powell\powelno01,SG,27,TOR,42,31,1277,282,566,.498,118,269,.439,164,297,.552,.602,141,163,.865,19,107,126,77,47,8,77,98,823
409,Norman Powell\powelno01,SF,27,POR,18,18,606,103,233,.442,31,95,.326,72,138,.522,.509,63,73,.863,17,39,56,36,27,7,33,43,300
410,Taurean Prince\princta02,PF,26,TOT,41,10,905,131,327,.401,62,155,.400,69,172,.401,.495,65,76,.855,19,123,142,76,28,23,47,75,389
410,Taurean Prince\princta02,PF,26,BRK,12,4,218,30,74,.405,13,37,.351,17,37,.459,.493,24,27,.889,2,32,34,7,8,8,11,21,97
410,Taurean Prince\princta02,PF,26,CLE,29,6,687,101,253,.399,49,118,.415,52,135,.385,.496,41,49,.837,17,91,108,69,20,15,36,54,292
411,Payton Pritchard\pritcpa01,SG,23,BOS,57,2,1110,159,353,.450,84,202,.416,75,151,.497,.569,37,41,.902,29,101,130,107,31,9,49,95,439
412,Immanuel Quickley\quickim01,PG,21,NYK,58,3,1131,212,538,.394,108,279,.387,104,259,.402,.494,145,162,.895,23,105,128,122,28,12,53,106,677
413,Jahmi'us Ramsey\ramseja01,SG,19,SAC,6,0,23,6,10,.600,2,6,.333,4,4,1.000,.700,0,0,,1,4,5,3,0,1,1,0,14
414,Chasson Randle\randlch01,PG,27,ORL,31,5,600,63,159,.396,33,90,.367,30,69,.435,.500,21,27,.778,3,50,53,58,16,2,35,49,180
415,Julius Randle\randlju01,PF,26,NYK,62,62,2325,525,1137,.462,139,330,.421,386,807,.478,.523,303,375,.808,79,564,643,367,59,16,211,195,1492
416,Cam Reddish\reddica01,SF,21,ATL,26,21,750,96,263,.365,33,126,.262,63,137,.460,.428,67,82,.817,22,82,104,35,33,9,34,68,292
417,J.J. Redick\redicjj01,SG,36,TOT,39,0,677,103,248,.415,63,162,.389,40,86,.465,.542,47,50,.940,4,58,62,46,10,3,33,41,316
417,J.J. Redick\redicjj01,SG,36,NOP,31,0,576,87,214,.407,51,140,.364,36,74,.486,.526,45,47,.957,3,49,52,40,9,2,25,37,270
417,J.J. Redick\redicjj01,SG,36,DAL,8,0,101,16,34,.471,12,22,.545,4,12,.333,.647,2,3,.667,1,9,10,6,1,1,8,4,46
418,Paul Reed\reedpa01,PF,21,PHI,20,0,132,29,55,.527,0,6,.000,29,49,.592,.527,1,4,.250,20,22,42,7,6,11,9,21,59
419,Naz Reid\reidna01,C,21,MIN,61,15,1169,257,497,.517,51,146,.349,206,351,.587,.568,108,148,.730,66,206,272,64,30,65,61,152,673
420,Cameron Reynolds\reynoca01,SF,25,SAS,3,0,6,1,2,.500,0,0,,1,2,.500,.500,0,0,,0,0,0,0,0,0,0,0,2
421,Nick Richards\richani01,PF,23,CHO,17,0,61,4,8,.500,0,1,.000,4,7,.571,.500,7,11,.636,2,7,9,2,0,0,3,7,15
422,Josh Richardson\richajo01,SG,27,DAL,48,48,1524,215,501,.429,72,228,.316,143,273,.524,.501,86,95,.905,42,126,168,132,42,21,66,117,588
423,Grant Riller\rillegr01,PG,23,CHO,5,0,21,6,9,.667,2,4,.500,4,5,.800,.778,0,0,,0,0,0,3,1,0,1,0,14
424,Austin Rivers\riverau01,SG,28,TOT,26,2,563,68,164,.415,31,95,.326,37,69,.536,.509,13,18,.722,6,51,57,52,17,2,25,41,180
424,Austin Rivers\riverau01,SG,28,NYK,21,2,442,58,135,.430,28,77,.364,30,58,.517,.533,10,14,.714,5,42,47,42,12,0,22,32,154
424,Austin Rivers\riverau01,SG,28,DEN,5,0,121,10,29,.345,3,18,.167,7,11,.636,.397,3,4,.750,1,9,10,10,5,2,3,9,26
425,Andre Roberson\roberan03,SG,29,BRK,5,0,63,2,14,.143,1,8,.125,1,6,.167,.179,1,2,.500,7,8,15,4,3,1,2,4,6
426,Duncan Robinson\robindu01,SF,26,MIA,63,63,2016,274,629,.436,216,537,.402,58,92,.630,.607,51,61,.836,5,220,225,112,34,15,72,159,815
427,Glenn Robinson III\robingl02,SF,27,SAC,23,2,369,42,99,.424,16,44,.364,26,55,.473,.505,21,23,.913,11,34,45,20,4,3,11,23,121
428,Jerome Robinson\robinje01,SG,23,WAS,17,6,305,28,95,.295,11,42,.262,17,53,.321,.353,16,20,.800,4,34,38,25,12,6,19,31,83
429,Justin Robinson\robinju01,PG,23,OKC,9,0,88,7,21,.333,4,14,.286,3,7,.429,.429,3,5,.600,1,6,7,9,3,0,2,10,21
430,Mitchell Robinson\robinmi01,C,22,NYK,31,29,853,115,176,.653,0,0,,115,176,.653,.653,26,53,.491,113,139,252,17,35,45,26,86,256
431,Isaiah Roby\robyis01,PF,22,OKC,51,26,1208,179,360,.497,29,88,.330,150,272,.551,.538,76,104,.731,80,214,294,97,43,34,95,139,463
432,Rajon Rondo\rondora01,PG,34,TOT,38,2,616,72,172,.419,26,70,.371,46,102,.451,.494,10,11,.909,13,71,84,154,29,3,58,48,180
432,Rajon Rondo\rondora01,PG,34,ATL,27,2,402,44,110,.400,17,45,.378,27,65,.415,.477,1,2,.500,4,51,55,95,19,2,39,25,106
432,Rajon Rondo\rondora01,PG,34,LAC,11,0,214,28,62,.452,9,25,.360,19,37,.514,.524,9,9,1.000,9,20,29,59,10,1,19,23,74
433,Derrick Rose\rosede01,PG,32,TOT,42,3,1046,225,504,.446,36,104,.346,189,400,.473,.482,94,111,.847,15,83,98,175,43,18,63,49,580
433,Derrick Rose\rosede01,PG,32,DET,15,0,342,79,184,.429,13,39,.333,66,145,.455,.465,42,50,.840,6,23,29,63,18,4,29,17,213
433,Derrick Rose\rosede01,PG,32,NYK,27,3,704,146,320,.456,23,65,.354,123,255,.482,.492,52,61,.852,9,60,69,112,25,14,34,32,367
434,Terrence Ross\rosste01,SG,29,ORL,46,2,1347,254,616,.412,89,264,.337,165,352,.469,.485,120,138,.870,15,143,158,108,47,21,74,88,717
435,Terry Rozier\roziete01,SG,26,CHO,59,59,2013,434,952,.456,191,487,.392,243,465,.523,.556,138,166,.831,33,215,248,244,73,24,112,105,1197
436,Ricky Rubio\rubiori01,PG,30,MIN,59,44,1531,157,419,.375,51,171,.298,106,248,.427,.436,113,132,.856,22,167,189,384,83,3,102,124,478
437,D'Angelo Russell\russeda01,PG,24,MIN,33,19,920,227,514,.442,98,241,.407,129,273,.473,.537,88,110,.800,11,71,82,172,33,14,90,56,640
438,Domantas Sabonis\sabondo01,PF,24,IND,53,53,1892,397,764,.520,42,139,.302,355,625,.568,.547,217,297,.731,134,481,615,319,60,29,178,179,1053
439,Luka Šamanić\samanlu01,PF,21,SAS,27,4,249,34,79,.430,9,37,.243,25,42,.595,.487,12,24,.500,13,42,55,13,7,6,16,36,89
440,JaKarr Sampson\sampsja02,PF,27,IND,24,3,241,36,79,.456,3,12,.250,33,67,.493,.475,15,25,.600,21,40,61,3,2,12,13,42,90
441,Dario Šarić\saricda01,C,26,PHO,41,1,719,132,293,.451,40,118,.339,92,175,.526,.519,68,78,.872,40,122,162,55,24,3,51,81,372
442,Tomáš Satoranský\satorto01,SG,29,CHI,50,18,1160,145,288,.503,39,105,.371,106,183,.579,.571,60,69,.870,26,97,123,245,40,12,86,78,389
443,Dennis Schröder\schrode01,SG,27,LAL,58,58,1865,320,727,.440,67,195,.344,253,532,.476,.486,200,237,.844,28,173,201,336,66,13,155,153,907
444,Mike Scott\scottmi01,PF,32,PHI,42,11,730,65,174,.374,46,133,.346,19,41,.463,.506,8,12,.667,9,98,107,30,23,7,18,64,184
445,Collin Sexton\sextoco01,SG,22,CLE,50,50,1783,449,922,.487,83,221,.376,366,701,.522,.532,242,297,.815,44,108,152,205,55,7,132,136,1223
446,Landry Shamet\shamela01,SG,23,BRK,51,7,1134,158,384,.411,108,278,.388,50,106,.472,.552,56,65,.862,9,83,92,77,26,5,42,79,480
447,Iman Shumpert\shumpim01,SG,30,BRK,2,0,11,1,4,.250,0,3,.000,1,1,1.000,.250,0,0,,1,0,1,0,1,0,1,0,2
448,Pascal Siakam\siakapa01,PF,26,TOR,50,50,1782,375,833,.450,64,219,.292,311,614,.507,.489,231,275,.840,84,275,359,231,54,35,110,164,1045
449,Chris Silva\silvach01,PF,24,TOT,15,0,92,10,16,.625,1,1,1.000,9,15,.600,.656,11,15,.733,7,20,27,6,1,6,10,24,32
449,Chris Silva\silvach01,PF,24,MIA,11,0,83,9,13,.692,1,1,1.000,8,12,.667,.731,11,15,.733,7,18,25,6,1,5,9,20,30
449,Chris Silva\silvach01,PF,24,SAC,4,0,9,1,3,.333,0,0,,1,3,.333,.333,0,0,,0,2,2,0,0,1,1,4,2
450,Ben Simmons\simmobe01,PG,24,PHI,50,50,1635,283,514,.551,3,10,.300,280,504,.556,.554,163,267,.610,81,293,374,351,82,33,162,151,732
451,Anfernee Simons\simonan01,SG,21,POR,54,0,894,148,348,.425,109,246,.443,39,102,.382,.582,38,49,.776,12,106,118,77,16,7,36,79,443
452,Deividas Sirvydis\sirvyde01,SG,20,DET,15,0,41,5,17,.294,4,13,.308,1,4,.250,.412,3,4,.750,0,8,8,2,1,0,3,3,17
453,Alen Smailagić\smailal01,PF,20,GSW,10,1,45,7,15,.467,2,5,.400,5,10,.500,.533,1,4,.250,3,5,8,3,2,4,0,6,17
454,Marcus Smart\smartma01,PG,26,BOS,42,39,1374,183,453,.404,85,252,.337,98,201,.488,.498,122,153,.797,31,109,140,230,65,20,76,107,573
455,Dennis Smith Jr.\smithde03,PG,23,TOT,23,9,420,58,145,.400,19,58,.328,39,87,.448,.466,19,26,.731,12,43,55,77,23,14,26,37,154
455,Dennis Smith Jr.\smithde03,PG,23,NYK,3,0,28,2,10,.200,0,4,.000,2,6,.333,.200,5,6,.833,0,2,2,3,3,0,1,4,9
455,Dennis Smith Jr.\smithde03,PG,23,DET,20,9,392,56,135,.415,19,54,.352,37,81,.457,.485,14,20,.700,12,41,53,74,20,14,25,33,145
456,Ish Smith\smithis01,PG,32,WAS,34,1,689,89,213,.418,14,37,.378,75,176,.426,.451,15,27,.556,16,93,109,142,22,10,33,46,207
457,Jalen Smith\smithja04,PF,20,PHO,22,0,89,11,30,.367,2,11,.182,9,19,.474,.400,1,3,.333,6,13,19,2,1,2,5,10,25
458,Tony Snell\snellto01,SG,29,ATL,40,18,839,76,147,.517,56,98,.571,20,49,.408,.707,11,11,1.000,15,79,94,51,9,10,18,62,219
459,Ray Spalding\spaldra01,C,23,HOU,2,0,19,2,4,.500,0,1,.000,2,3,.667,.500,0,2,.000,2,2,4,0,0,2,3,3,4
460,Cassius Stanley\stanlca01,SG,21,IND,18,0,53,8,25,.320,1,7,.143,7,18,.389,.340,6,7,.857,5,8,13,1,0,2,1,9,23
461,Lamar Stevens\stevela01,PF,23,CLE,40,0,499,62,136,.456,4,25,.160,58,111,.523,.471,37,51,.725,24,72,96,25,17,13,23,53,165
462,Isaiah Stewart\stewais01,C,19,DET,60,7,1225,189,329,.574,13,31,.419,176,298,.591,.594,50,74,.676,146,252,398,52,32,69,59,157,441
463,Max Strus\strusma01,SF,24,MIA,33,0,405,65,145,.448,40,117,.342,25,28,.893,.586,11,17,.647,3,26,29,17,7,1,7,37,181
464,Edmond Sumner\sumneed01,SG,25,IND,48,19,768,129,249,.518,32,83,.386,97,166,.584,.582,58,73,.795,17,69,86,44,30,10,46,78,348
465,Jae'Sean Tate\tateja01,SF,25,HOU,62,50,1811,279,537,.520,49,166,.295,230,371,.620,.565,85,119,.714,121,210,331,145,80,34,74,195,692
466,Jayson Tatum\tatumja01,SF,22,BOS,56,56,1999,519,1141,.455,162,423,.383,357,718,.497,.526,246,283,.869,42,375,417,245,66,22,151,104,1446
467,Jeff Teague\teaguje01,PG,32,TOT,46,6,817,101,241,.419,30,72,.417,71,169,.420,.481,70,83,.843,13,65,78,112,28,10,50,54,302
467,Jeff Teague\teaguje01,PG,32,BOS,34,5,616,78,188,.415,26,56,.464,52,132,.394,.484,51,61,.836,10,47,57,73,26,7,39,43,233
467,Jeff Teague\teaguje01,PG,32,MIL,12,1,201,23,53,.434,4,16,.250,19,37,.514,.472,19,22,.864,3,18,21,39,2,3,11,11,69
468,Garrett Temple\templga01,SG,34,CHI,46,20,1245,136,319,.426,59,169,.349,77,150,.513,.519,33,40,.825,23,107,130,102,36,21,49,102,364
469,Tyrell Terry\terryty01,PG,20,DAL,11,0,56,5,16,.313,0,7,.000,5,9,.556,.313,1,3,.333,0,6,6,6,5,0,2,2,11
470,Daniel Theis\theisda01,C,28,TOT,59,45,1431,227,418,.543,43,139,.309,184,279,.659,.594,65,97,.670,77,233,310,101,33,54,60,150,562
470,Daniel Theis\theisda01,C,28,BOS,42,37,1027,159,288,.552,33,95,.347,126,193,.653,.609,46,67,.687,54,166,220,67,25,43,41,120,397
470,Daniel Theis\theisda01,C,28,CHI,17,8,404,68,130,.523,10,44,.227,58,86,.674,.562,19,30,.633,23,67,90,34,8,11,19,30,165
471,Brodric Thomas\thomabr01,SG,24,TOT,22,1,198,18,61,.295,9,35,.257,9,26,.346,.369,18,25,.720,4,20,24,16,8,6,14,21,63
471,Brodric Thomas\thomabr01,SG,24,HOU,4,0,24,2,7,.286,1,6,.167,1,1,1.000,.357,5,7,.714,1,3,4,4,1,1,4,5,10
471,Brodric Thomas\thomabr01,SG,24,CLE,18,1,174,16,54,.296,8,29,.276,8,25,.320,.370,13,18,.722,3,17,20,12,7,5,10,16,53
472,Isaiah Thomas\thomais02,PG,31,NOP,3,0,48,9,27,.333,3,12,.250,6,15,.400,.389,2,2,1.000,1,3,4,5,1,0,6,3,23
473,Matt Thomas\thomama02,SG,26,TOT,36,0,271,41,102,.402,23,65,.354,18,37,.486,.515,6,7,.857,5,28,33,14,3,0,12,15,111
473,Matt Thomas\thomama02,SG,26,TOR,26,0,192,24,62,.387,17,41,.415,7,21,.333,.524,6,7,.857,3,18,21,9,2,0,6,10,71
473,Matt Thomas\thomama02,SG,26,UTA,10,0,79,17,40,.425,6,24,.250,11,16,.688,.500,0,0,,2,10,12,5,1,0,6,5,40
474,Tristan Thompson\thomptr01,PF,29,BOS,48,39,1119,155,293,.529,0,3,.000,155,290,.534,.529,67,110,.609,149,239,388,55,20,25,53,103,377
475,Sindarius Thornwell\thornsi01,SG,26,NOP,14,1,73,7,21,.333,3,9,.333,4,12,.333,.405,0,2,.000,1,4,5,4,5,1,4,3,17
476,Matisse Thybulle\thybuma01,SG,23,PHI,59,7,1179,89,215,.414,39,128,.305,50,87,.575,.505,8,17,.471,30,88,118,55,91,62,28,115,225
477,Killian Tillie\tilliki02,C,22,MEM,15,0,127,13,42,.310,6,26,.231,7,16,.438,.381,6,7,.857,6,11,17,5,5,7,1,17,38
478,Xavier Tillman Sr.\tillmxa01,PF,22,MEM,50,10,940,145,261,.556,18,56,.321,127,205,.620,.590,32,48,.667,63,155,218,64,39,28,35,107,340
479,Anthony Tolliver\tollian01,PF,35,PHI,5,0,62,1,10,.100,1,7,.143,0,3,.000,.150,5,6,.833,3,5,8,2,3,2,3,6,8
480,Obi Toppin\toppiob01,PF,22,NYK,53,0,585,88,180,.489,21,73,.288,67,107,.626,.547,16,22,.727,23,96,119,24,13,11,21,47,213
481,Juan Toscano-Anderson\toscaju01,SG,27,GSW,43,15,803,90,155,.581,26,63,.413,64,92,.696,.665,17,23,.739,25,146,171,103,26,17,45,87,223
482,Axel Toupane\toupaax01,SF,28,MIL,8,1,61,4,11,.364,1,2,.500,3,9,.333,.409,5,7,.714,0,6,6,4,2,3,0,6,14
483,Karl-Anthony Towns\townska01,C,25,MIN,41,41,1405,355,720,.493,99,253,.391,256,467,.548,.562,209,242,.864,109,334,443,186,29,55,134,149,1018
484,Gary Trent Jr.\trentga02,SG,22,TOT,55,35,1699,304,733,.415,157,404,.389,147,329,.447,.522,71,91,.780,22,117,139,77,54,9,41,84,836
484,Gary Trent Jr.\trentga02,SG,22,POR,41,23,1262,217,524,.414,121,305,.397,96,219,.438,.530,58,75,.773,21,70,91,58,37,6,31,63,613
484,Gary Trent Jr.\trentga02,SG,22,TOR,14,12,437,87,209,.416,36,99,.364,51,110,.464,.502,13,16,.813,1,47,48,19,17,3,10,21,223
485,P.J. Tucker\tuckepj01,PF,35,TOT,42,32,1139,58,156,.372,34,103,.330,24,53,.453,.481,18,23,.783,43,135,178,50,33,20,35,102,168
485,P.J. Tucker\tuckepj01,PF,35,HOU,32,32,959,48,131,.366,27,86,.314,21,45,.467,.469,18,23,.783,33,115,148,45,29,18,33,91,141
485,P.J. Tucker\tuckepj01,PF,35,MIL,10,0,180,10,25,.400,7,17,.412,3,8,.375,.540,0,0,,10,20,30,5,4,2,2,11,27
486,Rayjon Tucker\tuckera01,PG,23,PHI,12,0,49,5,11,.455,2,5,.400,3,6,.500,.545,12,14,.857,1,8,9,5,2,0,3,5,24
487,Myles Turner\turnemy01,C,24,IND,47,47,1455,206,432,.477,69,206,.335,137,226,.606,.557,111,142,.782,63,243,306,48,40,159,67,165,592
488,Jonas Valančiūnas\valanjo01,C,28,MEM,53,52,1479,375,646,.580,20,54,.370,355,592,.600,.596,133,172,.773,212,435,647,95,29,38,88,151,903
489,Denzel Valentine\valende01,SG,27,CHI,55,3,945,141,372,.379,72,221,.326,69,151,.457,.476,14,15,.933,21,162,183,89,29,6,39,61,368
490,Jarred Vanderbilt\vandeja01,PF,21,MIN,55,25,944,114,193,.591,1,4,.250,113,189,.598,.593,53,94,.564,94,206,300,69,51,40,51,106,282
491,Fred VanVleet\vanvlfr01,SG,26,TOR,49,49,1773,310,796,.389,161,439,.367,149,357,.417,.491,159,180,.883,28,178,206,303,81,36,91,114,940
492,Devin Vassell\vassede01,SF,20,SAS,51,2,814,91,224,.406,45,115,.391,46,109,.422,.507,30,36,.833,19,111,130,45,39,15,18,68,257
493,Gabe Vincent\vincega01,PG,24,MIA,44,6,599,76,211,.360,38,135,.281,38,76,.500,.450,20,23,.870,10,38,48,55,19,2,30,71,210
494,Noah Vonleh\vonleno01,PF,25,BRK,4,0,11,0,3,.000,0,2,.000,0,1,.000,.000,0,0,,0,1,1,1,0,0,2,2,0
495,Nikola Vučević\vucevni01,C,30,TOT,63,63,2114,610,1247,.489,163,390,.418,447,857,.522,.555,125,150,.833,126,593,719,235,60,43,116,120,1508
495,Nikola Vučević\vucevni01,C,30,ORL,44,44,1500,436,908,.480,117,288,.406,319,620,.515,.545,91,110,.827,87,430,517,167,42,28,83,79,1080
495,Nikola Vučević\vucevni01,C,30,CHI,19,19,614,174,339,.513,46,102,.451,128,237,.540,.581,34,40,.850,39,163,202,68,18,15,33,41,428
496,Dean Wade\wadede01,PF,24,CLE,53,13,900,98,231,.424,56,157,.357,42,74,.568,.545,18,23,.783,27,134,161,60,23,19,20,57,270
497,Moritz Wagner\wagnemo01,C,23,TOT,35,14,445,67,139,.482,15,49,.306,52,90,.578,.536,42,54,.778,17,77,94,39,22,9,31,73,191
497,Moritz Wagner\wagnemo01,C,23,WAS,25,13,375,62,122,.508,13,42,.310,49,80,.613,.561,41,52,.788,13,60,73,32,22,8,21,62,178
497,Moritz Wagner\wagnemo01,C,23,BOS,9,1,61,4,14,.286,2,6,.333,2,8,.250,.357,1,2,.500,3,16,19,6,0,1,9,10,11
497,Moritz Wagner\wagnemo01,F-C,23,ORL,1,0,9,1,3,.333,0,1,.000,1,2,.500,.333,0,0,,1,1,2,1,0,0,1,1,2
498,Kemba Walker\walkeke02,PG,30,BOS,39,39,1227,244,597,.409,110,316,.348,134,281,.477,.501,112,122,.918,13,141,154,195,43,11,80,55,710
499,Lonnie Walker\walkelo01,SG,22,SAS,49,31,1220,200,482,.415,79,221,.357,121,261,.464,.497,51,64,.797,10,115,125,79,24,14,54,87,530
500,John Wall\walljo01,PG,30,HOU,40,40,1288,293,726,.404,79,249,.317,214,477,.449,.458,158,211,.749,17,112,129,275,42,31,141,46,823
501,Brad Wanamaker\wanambr01,PG,31,TOT,55,0,939,105,276,.380,16,84,.190,89,192,.464,.409,77,87,.885,13,79,92,158,39,11,66,86,303
501,Brad Wanamaker\wanambr01,PG,31,GSW,39,0,625,61,173,.353,13,61,.213,48,112,.429,.390,50,56,.893,8,58,66,99,26,6,37,55,185
501,Brad Wanamaker\wanambr01,PG,31,CHO,16,0,314,44,103,.427,3,23,.130,41,80,.513,.442,27,31,.871,5,21,26,59,13,5,29,31,118
502,T.J. Warren\warretj01,SF,27,IND,4,4,117,27,51,.529,0,7,.000,27,44,.614,.529,8,10,.800,2,12,14,5,2,0,4,16,62
503,P.J. Washington\washipj01,PF,22,CHO,55,52,1643,250,563,.444,91,228,.399,159,335,.475,.525,100,133,.752,77,265,342,143,52,70,113,144,691
504,Yuta Watanabe\watanyu01,SF,26,TOR,43,1,587,66,143,.462,29,70,.414,37,73,.507,.563,19,23,.826,33,103,136,30,20,17,17,50,180
505,Tremont Waters\watertr01,PG,23,BOS,19,2,152,18,48,.375,7,21,.333,11,27,.407,.448,13,14,.929,3,9,12,42,13,0,18,12,56
506,Paul Watson\watsopa01,SF,26,TOR,27,2,297,38,82,.463,30,64,.469,8,18,.444,.646,5,8,.625,4,41,45,17,6,3,9,36,111
507,Quinndary Weatherspoon\weathqu01,SG,24,SAS,17,0,76,6,16,.375,0,2,.000,6,14,.429,.375,7,8,.875,2,4,6,5,6,2,9,13,19
508,Russell Westbrook\westbru01,PG,32,WAS,55,55,1971,454,1040,.437,69,222,.311,385,818,.471,.470,216,343,.630,92,522,614,607,73,19,274,156,1193
509,Coby White\whiteco01,PG,20,CHI,59,44,1820,314,756,.415,126,366,.344,188,390,.482,.499,116,127,.913,23,219,242,274,32,12,132,152,870
510,Derrick White\whitede01,SG,26,SAS,36,32,1064,186,453,.411,84,243,.346,102,210,.486,.503,97,114,.851,13,94,107,127,26,36,45,91,553
511,Hassan Whiteside\whiteha01,C,31,SAC,36,4,546,126,224,.563,0,1,.000,126,223,.565,.563,41,79,.519,61,154,215,20,9,46,40,73,293
512,Greg Whittington\whittgr01,PF,27,DEN,4,0,12,0,3,.000,0,2,.000,0,1,.000,.000,0,0,,0,0,0,0,0,0,0,0,0
513,Andrew Wiggins\wiggian01,PF,25,GSW,62,62,2046,419,894,.469,120,318,.377,299,576,.519,.536,154,218,.706,67,232,299,147,63,60,113,135,1112
514,Grant Williams\willigr01,PF,22,BOS,55,8,1005,87,205,.424,41,112,.366,46,93,.495,.524,22,40,.550,43,110,153,54,30,21,49,139,237
515,Kenrich Williams\willike04,PF,26,OKC,62,12,1324,195,367,.531,45,104,.433,150,263,.570,.593,35,61,.574,82,178,260,137,46,15,70,130,470
516,Lou Williams\willilo02,PG,34,TOT,57,4,1279,245,588,.417,63,160,.394,182,428,.425,.470,139,160,.869,20,98,118,196,47,5,93,57,692
516,Lou Williams\willilo02,PG,34,LAC,42,3,918,181,430,.421,45,119,.378,136,311,.437,.473,103,119,.866,15,73,88,144,39,4,66,42,510
516,Lou Williams\willilo02,PG,34,ATL,15,1,361,64,158,.405,18,41,.439,46,117,.393,.462,36,41,.878,5,25,30,52,8,1,27,15,182
517,Patrick Williams\willipa01,PF,19,CHI,61,61,1708,217,453,.479,46,121,.380,171,332,.515,.530,75,99,.758,53,227,280,86,53,39,85,112,555
518,Robert Williams\williro04,C,23,BOS,48,10,905,174,242,.719,0,2,.000,174,240,.725,.719,42,65,.646,126,210,336,83,41,86,50,101,390
519,Zion Williamson\willizi01,PF,20,NOP,57,57,1876,588,955,.616,10,31,.323,578,924,.626,.621,342,491,.697,148,256,404,204,51,36,150,133,1528
520,D.J. Wilson\wilsodj01,PF,24,TOT,33,1,383,61,150,.407,27,79,.342,34,71,.479,.497,13,21,.619,15,79,94,21,10,15,20,41,162
520,D.J. Wilson\wilsodj01,PF,24,MIL,12,0,105,16,43,.372,10,28,.357,6,15,.400,.488,1,2,.500,3,22,25,3,1,4,4,13,43
520,D.J. Wilson\wilsodj01,PF,24,HOU,21,1,278,45,107,.421,17,51,.333,28,56,.500,.500,12,19,.632,12,57,69,18,9,11,16,28,119
521,Dylan Windler\windldy01,SF,24,CLE,31,0,513,57,130,.438,26,77,.338,31,53,.585,.538,21,27,.778,20,87,107,33,19,12,32,37,161
522,Justise Winslow\winslju01,SF,24,MEM,22,0,438,62,179,.346,6,45,.133,56,134,.418,.363,15,24,.625,14,80,94,43,15,12,34,40,145
523,Cassius Winston\winstca01,PG,22,WAS,19,0,93,13,31,.419,8,16,.500,5,15,.333,.548,5,6,.833,0,9,9,11,2,1,2,8,39
524,James Wiseman\wisemja01,C,19,GSW,39,27,836,191,368,.519,12,38,.316,179,330,.542,.535,54,86,.628,55,171,226,26,11,36,60,121,448
525,Christian Wood\woodch01,C,25,HOU,38,38,1223,309,590,.524,69,183,.377,240,407,.590,.582,113,179,.631,69,302,371,61,32,46,71,79,800
526,Robert Woodard\woodaro01,SF,21,SAC,11,0,29,7,14,.500,1,4,.250,6,10,.600,.536,3,8,.375,3,8,11,0,0,2,1,2,18
527,Delon Wright\wrighde01,SG-PG,28,TOT,53,31,1417,182,401,.454,46,126,.365,136,275,.495,.511,97,121,.802,50,164,214,217,79,22,61,62,507
527,Delon Wright\wrighde01,SG,28,DET,36,31,1052,136,293,.464,31,89,.348,105,204,.515,.517,71,90,.789,37,127,164,181,58,19,48,45,374
527,Delon Wright\wrighde01,PG,28,SAC,17,0,365,46,108,.426,15,37,.405,31,71,.437,.495,26,31,.839,13,37,50,36,21,3,13,17,133
528,Thaddeus Young\youngth01,PF,32,CHI,58,17,1400,319,552,.578,10,37,.270,309,515,.600,.587,54,86,.628,141,214,355,246,66,32,115,137,702
529,Trae Young\youngtr01,PG,22,ATL,54,54,1849,413,962,.429,123,345,.357,290,617,.470,.493,416,476,.874,35,177,212,516,48,11,228,100,1365
530,Cody Zeller\zelleco01,C,28,CHO,39,20,814,143,262,.546,4,26,.154,139,236,.589,.553,66,89,.742,100,168,268,74,23,14,40,91,356
531,Ivica Zubac\zubaciv01,C,23,LAC,64,25,1437,232,359,.646,0,3,.000,232,356,.652,.646,123,156,.788,175,292,467,80,24,56,74,167,587
